+++++++++++++++++++++++++++++++++++++++++++++++++++++++++++++++++++++++++++++++++++++++++++++++++++++++
+++++++++++++++++++++++++++++++++++++++++++++++++++++++++++++++++++++++++++++++++++++++++++++++++++++++
+++++++++++++++++++++++++++++++++++++++++++++++++++++++++++++++++++++++++++++++++++++++++++++++++++++++
++++++++++++++++++++++++++++++++++++++++++++++++++++++++++++++++++++++++++++++++++++rrrrrrrrrrrrr++++++
++++++++++++++++++++++++++++++++++++++++++++++++++++++++++++++++++++++++++++++++++++r+++++++++++r++++++
++++++++++++++++++++++++++++++++++++++++++++++++++++++++++++++++++++++++++++++++++++r+++++++++++r++++++
++++++++++++++++++++++++++++++++++++++++++++++++++++++++++++++++++++++++++++++++++++r+++++4+++++r++++++
++++++++++++++++++++++++++++++++++++++++++++++++++++++++++++++++++++++++++++++++++++r+++++++++++r++++++
++++++++++++++++++++++++++++++++++++++++++++++++++++++++++++++++++++++++++++++++++++r+++++++++++r++++++
++++++++++++++++++++++++++++++++++++++++++++++++++++++++++++++++++++++++++++++++++++r+++++rIIIIIr++++++
++++++++++++++++++++++++++++++++++++++++++++++++++++++++++++++++++++++++++++++++++++r+++++rIIIIIr++++++
++++++++++++++++++++++++++++++++++++++++++++++++++++++++++++++++++++++++++++++++++++r++1++rIIIIIr++++++
++++++++++++++++++++++++++++++++++++++++++++++++++++++++++++++++++++++++++++++++++++r+++++r^^^^^r++++++
++++++++++++++++++++++++++++++++++++++++++++++++++++++++++++++++++++++++++++++++++++r+++++rIIIIIr++++++
++++++++++++++++++++++++++++++++++++++++++++++++++++++++++++++++++++++++++++++++++++r+++++rIIIIIr++++++
++++++++++++++++++++++++++++++++++++++++++++++++++++++++++++++++++++++++++++++++++++r+++++r^^^^^r++++++
++++++++++++++++++++++++++++++++++++++++++++++++++++++++++++++++++++++++++++++++++++r+++++rIIIIIr++++++
++++++++++++++++++++++++++++++++++++++++++++++++++++++++++++++++++++++++++++++++++++r++1++rIIIIIr++++++
++++++++++++++++++++++++++++++++++++++++++++++++++++++++++++++++++++++++++++++++++++r+++++r^^^^^r++++++
++++++++++++++++++++++++++++++++++++++++++++++++++++++++++++++++++++++++++++++++++++r+++++r^^^^^r++++++
++++++++++++++++++++++++++++++++++++++++++++++++++++++++++++++++++++++++++++++++++++r+++++rIIIIIr++++++
++++++++++++++++++++++++++++++++++++++++++++++++++++++++++++++++++++++++++++++++++++r+++++rIIIIIr++++++
++++++++++++++++++++++++++++++++++++++++++++++++++++++++++++++++++++++++++++++++++++r+++++rIIIIIr++++++
++++++++++++++++++++++++++++++++++++++++++++++++++++++++++++++++++++++++++++++++++++r++1++r^^^^^r++++++
++++++++++++++++++++++++++++++++++++++++++++++++++++++++++++++++++++++++++++++++++++r+++++rIIIIIr++++++
++++++++++++++++++++++++++++++++++++++++++++++++++++++++++++++++++++++++++++++++++++r+++++r^^^^^r++++++
+++++++++++++++++++++++++++++++++++++++++++++rrrrrrrrrrrrr++++++++++++++++++++++++++r+++++rIIIIIr++++++
+++++++++++++++++++++++++++++++++++++++++++++r+++++++++++r++++++++++++++++++++++++++rOOOOOrIIIIIr++++++
+++++++++++++++++++++++++++++++++++++++++++++r+++++4+++++r++++++++++++++++++++++++++rO+++OrIIIIIr++++++
+++++++++++++++++++++++++++++++++++++++++++++r+++++++++++r++++++++++++++++++++++++++rO+++Or^^^^^r++++++
+++++++++++++++++++++++++++++++++++++++++++++r++1++r++1++r++++++++++++++++++++++++++rOOOOOr^^^^^r++++++
+++++++++++++++++++++++++++++++++++++++++++++r+++++r+++++r++++++++++++++++++++++++++r++O++rIIIIIr++++++
+++++++++++++++++++++++++++++++++++++++++++++r+++++r++2++r++++++++++++++++++++++++++r++O++rIIIIIr++++++
+++++++++++++++++++++++++++++++++++++++++++++r+++++r+++++r++++++++++++++++++++++++++rOOOOOrIIIIIr++++++
+++++++++++++++++++++++++++++++++++++++++++++r++2++r+++++r++++++++++++++++++++++++++rO+++OrIIIIIr++++++
+++++++++++++++++++++++++++++++++++++++++++++r+++++r+++++r++++++++++++++++++++++++++rO+++OrIIIIIr++++++
+++++++++++++++++++++++++++++++++++++++++++++r++1++r++1++r++++++++++++++++++++++++++rOOOOOrOOOOOr++++++
+++++++++++++++++++++++++++++++++++++++++++++r+++++r+++++r++++++++++++++++++++++++++r++O++rIIIIIr++++++
+++++++++++++++++++++++++++++++++++++++++++++r+++++r++2++r++++++++++++++++++++++++++r++O++rIIIIIr++++++
+++++++++++++++++++++++++++++++++++++++++++++r+++++r+++++r++++++++++++++++++++++++++rOOOOOrIIIIIr++++++
+++++++++++++++++++++++++++++++++++++++++++++r+++++r+++++r++++++++++++++++++++++++++rO+++OrIIIIIr++++++
+++++++++++++++++++++++++++++++++++++++++++++r+++++r+++++r++++++++++++++++++++++++++rO+++OrIIIIIr++++++
++++++rrrrrrrrrrrrrrrrrrrrrrrrrrrrrrrrrrrrrrrr+++++r+++++rrrrrrrrrrrrrrrrrrrrrrrrrrrrOOOOOr^^^^^r++++++
++++++r++++++++++++++++++++++++++++++++++++++++++++rEEEEr+++++++++++++++++++++++++++++++++r+++++r++++++
++++++r++++++++++++++++++++++++++++++++++++++++23++r+++M++++++++++++++++++++++++++++++++++r+++++r++++++
++++++r++2++++++1+2+3++++4++++3+2+1++++++++++++1^^^r++r++++S+++++++1+1+1+++++++121++++++++r+++++r++++++
++++++r+++++++++++++++++++++++++++++++++++++++++^^^r+r++++++++++++++++++++++++++++++++++++r+++++r++++++
++++++r+++++++++++++++++++++++++++++++++++++++++^^4rr+++++++++++++++++++++++++++++++++++++r+++++r++++++
++++++r++4++rrrrrrrrrrrrrrrrrrrrrrrrrrrrrrrrrrrrrrrrrrrrrrrrrrrrrrrrrrrrrrrrrrrrrrrrrrrrrrr+++++r++++++
++++++r+++++++++++++++++++++++++++++++++++++++++3++++++++++++++++++++++++++++++++++3++++++++++++r++++++
++++++r+++++++++++++++++++++++++++++++++++++++++++++++++++++++++++++++++++++++++3+++++++++++++++r++++++
++++++r++2++++++++++++++++++123++++++++++++++++12+++++++++++123++++++++++1+++3++++++++++++++++++r++++++
++++++r+++++++++++++++++++++++++++++++++++++++++++++++++++++++++++++++++++++++++3+++++++++++++++r++++++
++++++r+++++++++++++++++++++++++++++++++++++++++3++++++++++++++++++++++++++++++++++3++++++++++++r++++++
++++++rrrrrrrrrrrrrrrrrrrrrrrrrrrrrrrrrrrrrrrrrrrrrrrrrrrrrrrrrrrrrrrrrrrrrrrrrrrrrrrrrrrrrrrrrrr++++++
+++++++++++++++++++++++++++++++++++++++++++++++++++++++++++++++++++++++++++++++++++++++++++++++++++++++
+++++++++++++++++++++++++++++++++++++++++++++++++++++++++++++++++++++++++++++++++++++++++++++++++++++++
+++++++++++++++++++++++++++++++++++++++++++++++++++++++++++++++++++++++++++++++++++++++++++++++++++++++