+++++++++++++++++++++++++++++++++++++++++++++++++++++++++++++++++++++++++++++
+++++++++++++++++++++++++++++++++++++++++++++++++++++++++++++++++++++++++++++
+++++++++++++++++++++++++++++++++++++++++++++++++++++++++++++++++++++++++++++
++++++rrrrrrrrrrrrrrrrrrrrrrrrrrrrrrrrrrrrrrrrrrrrrrrrrrrrrrrrrrrrrrrrr++++++
++++++r++++++++++++1+++++++++++1+++++++++++1+++++++++++1+++++++++++r++r++++++
++++++r++M+S+++++++++++++++++++++++++++++++++++++++++++++++++++++++r++r++++++
++++++r++++++++++++++3+++++++++++3+++++++++++3+++++++++++3+++++++++r++r++++++
++++++r++++++++++++++++++++++++++++++++++++++++++++++++++++++++++++r++r++++++
++++++r++++++++++++++++2+++++++++++2+++++++++++2+++++++++++2+++++++r++r++++++
++++++r++++++++++++++++++++++++++++++++++++++++++++++++++++++++++++r++r++++++
++++++r++++++1+++++++++++1+++++++++++1+++++++++++1+++++++++++1+++++r++r++++++
++++++r++++++++++++++++++++++++++++++++++++++++++++++++++++++++++++r++r++++++
++++++r++++++++3+++++++++++3+++++++++++3+++++++++++3+++++++++++3+++r++r++++++
++++++r++++++++++++++++++++++++++++++++++++++++++++++++++++++++++++r++r++++++
++++++r++++++++++2+++++++++++2+++++++++++2+++++++++++2+++++++++++2+r++r++++++
++++++r++++++++++++++++++++++++++++++++++++++++++++++++++++++++++++r++r++++++
++++++r1+++++++++++1+++++++++++1+++++++++++1+++++++++++1+++++++++++r++r++++++
++++++r++++++++++++++++++++++++++++++++++++++++++++++++++++++++++++r++r++++++
++++++r++3+++++++++++3+++++++++++3+++++++++++3+++++++++++3+++++++++r++r++++++
++++++r++++++++++++++++++++++++++++++++++++++++++++++++++++++++++++r++r++++++
++++++r++++2+++++++++++2+++++++++++2+++++++++++2+++++++++++2+++++++r++r++++++
++++++r++++++++++++++++++++++++++++++++++++++++++++++++++++++++++++r++r++++++
++++++r++++++1+++++++++++1+++++++++++1+++++++++++1+++++++++++1+++++r++r++++++
++++++r++++++++++++++++++++++++++++++++++++++++++++++++++++++++++++r++r++++++
++++++r++++++++3+++++++++++3+++++++++++3+++++++++++3+++++++++++3+++r++r++++++
++++++r++++++++++++++++++++++++++++++++++++++++++++++++++++++++++++r++r++++++
++++++r++++++++++2+++++++++++2+++++++++++2+++++++++++2+++++++++++2+r++r++++++
++++++r++++++++++++++++++++++++++++++++++++++++++++++++++++++++++++r++r++++++
++++++r1+++++++++++1+++++++++++1+++++++++++1+++++++++++1+++++++++++r++r++++++
++++++r++++++++++++++++++++++++++++++++++++++++++++++++++++++++++++r++r++++++
++++++r++3+++++++++++3+++++++++++3+++++++++++3+++++++++++3+++++++++r++r++++++
++++++r++++++++++++++++++++++++++++++++++++++++++++++++++++++++++++r++r++++++
++++++r++++2+++++++++++2+++++++++++2+++++++++++2+++++++++++2+++++++r++r++++++
++++++r++++++++++++++++++++++++++++++++++++++++++++++++++++++++++++r++r++++++
++++++r++++++1+++++++++++1+++++++++++1+++++++++++1+++++++++++1++++++++r++++++
++++++r+++++++++++++++++++++++++++++++++++++++++++++++++++++++++++++++r++++++
++++++r++++++++3+++++++++++3+++++++++++3+++++++++++3+++++++++++3++++++r++++++
++++++r+++++++++++++++++++++++++++++++++++++++++++++++++++++++++++++++r++++++
++++++r++++++++++2+++++++++++2+++++++++++2+++++++++++2+++++++++++2++++r++++++
++++++r++++++++++++++++++++++++++++++++++++++++++++++++++++++++++++r++r++++++
++++++r1+++++++++++1+++++++++++1+++++++++++1+++++++++++1+++++++++++r++r++++++
++++++r++++++++++++++++++++++++++++++++++++++++++++++++++++++++++++r++r++++++
++++++r++3+++++++++++3+++++++++++3+++++++++++3+++++++++++3+++++++++r++r++++++
++++++r++++++++++++++++++++++++++++++++++++++++++++++++++++++++++++r++r++++++
++++++r++++2+++++++++++2+++++++++++2+++++++++++2+++++++++++2+++++++r++r++++++
++++++r++++++++++++++++++++++++++++++++++++++++++++++++++++++++++++r++r++++++
++++++r++++++1+++++++++++1+++++++++++1+++++++++++1+++++++++++1+++++r++r++++++
++++++r++++++++++++++++++++++++++++++++++++++++++++++++++++++++++++r++r++++++
++++++r++++++++3+++++++++++3+++++++++++3+++++++++++3+++++++++++3+++r++r++++++
++++++r++++++++++++++++++++++++++++++++++++++++++++++++++++++++++++r++r++++++
++++++r++++++++++2+++++++++++2+++++++++++2+++++++++++2+++++++++++2+r++r++++++
++++++r++++++++++++++++++++++++++++++++++++++++++++++++++++++++++++r++r++++++
++++++r1+++++++++++1+++++++++++1+++++++++++1+++++++++++1+++++++++++r++r++++++
++++++r++++++++++++++++++++++++++++++++++++++++++++++++++++++++++++r++r++++++
++++++r++3+++++++++++3+++++++++++3+++++++++++3+++++++++++3+++++++++r++r++++++
++++++r++++++++++++++++++++++++++++++++++++++++++++++++++++++++++++r++r++++++
++++++r++++2+++++++++++2+++++++++++2+++++++++++2+++++++++++2+++++++r++r++++++
++++++r++++++++++++++++++++++++++++++++++++++++++++++++++++++++++++r++r++++++
++++++r++++++1+++++++++++1+++++++++++1+++++++++++1+++++++++++1+++++r++r++++++
++++++r++++++++++++++++++++++++++++++++++++++++++++++++++++++++++++r++r++++++
++++++r++++++++3+++++++++++3+++++++++++3+++++++++++3+++++++++++3+++r++r++++++
++++++r++++++++++++++++++++++++++++++++++++++++++++++++++++++++++++r++r++++++
++++++r++++++++++2+++++++++++2+++++++++++2+++++++++++2+++++++++++2+r++r++++++
++++++r++++++++++++++++++++++++++++++++++++++++++++++++++++++++++++r++r++++++
++++++rrrrrrrrrrrrrrrrrrrrrrrrrrrrrrr++++++rrrrrrrrrrrrrrrrrrrrrrrrr+Er++++++
++++++r+++++++++++++++++++++++++++++++++++++++++++++++++++++++++++++EEr++++++
++++++r++++++++++++++++++++++++++++++++++++++++++++++++++++++++++++EEMr++++++
++++++rrrrrrrrrrrrrrrrrrrrrrrrrrrrrrrrrrrrrrrrrrrrrrrrrrrrrrrrrrrrrrrrr++++++
+++++++++++++++++++++++++++++++++++++++++++++++++++++++++++++++++++++++++++++
+++++++++++++++++++++++++++++++++++++++++++++++++++++++++++++++++++++++++++++
+++++++++++++++++++++++++++++++++++++++++++++++++++++++++++++++++++++++++++++