++++++++++++++++++++++++++++++++++++++++++++++++++++++++++++++++++++++++++++++++++++++++++++++++++
++++++++++++++++++++++++++++++++++++++++++++++++++++++++++++++++++++++++++++++++++++++++++++++++++
++++++++++++++++++++++++++++++++++++++++++++++++++++++++++++++++++++++++++++++++++++++++++++++++++
++++++rrrrrrr+++rrrrrrrrrrrrrrrrrrrrrrrrrrrrrrr+++rrrrrrrrrrrrrrrrrrrrrrrrrrrrrrrrr+++rrrrrr++++++
++++++r+M+++r+++r+++++++++++^+++IIIIIOOr+++++++r+r++++++++++++++++++++O^^r+++++++++r++r++++r++++++
+++++++r+S+++r+r++++++++++++^++++IIIIO&r++++++&+r+&++++++++++3++++++++4^^r&+++++++++r+r++M+r++++++
+++++++r+++++r+r+++++rrrrrrrr+++++rrrrrrr++++++++^++++++r++++rrrrrrrrrrrrr++++r++++++rrEEEEr++++++
++++++++r+++++r+++++r+++++++r+++++r++++++r++++++1+^++++r++1++r++++++++++++++++rr++++++r++++r++++++
++++++++r+^^^+r+^^^+r+++++++r++2++r+++++++r++++++++^++r++++++rrrrrr+++++++++++r+r++++^+++++r++++++
++++++++r+++++r+++++r+++++++r+++++r++++++++r^+++2+++^r+++2+++3++++r+++2++2++++r++r++^++++++r++++++
++++++++r+++++r+++++r+++++++r++2++r+++++++r++^++++++++r++++++rrrrrr+++++++++++r+++r^+++++++r++++++
++++++++r+++++r+++++r+++++++r+++++r++++++r++++^+1++++++r++1++r++++++++++++++++r++++r+++++++r++++++
++++++++r+++1+r+1+++r++rrrrrr++2++rrrrrrr++++++^++++++++r++++rrrrrrrrrrrrr++++r+++++r++++++r++++++
+++++++++r+++++++++r+++r+++++++++++++^+^++++++++r++++4++r++++++++++^++++++++++r++++++r+++++r++++++
+++++++++r++++2++++r+++r+&+4+++++++++^+^++++++&r+r&+++++r++++^+++++++++++^++++r+++++++r+++&r++++++
++++++++++rrrrrrrrr++++rrrrrrrrrrrrrrrrrrrrrrrr+++rrrrrrrrrrrrrrrrrrrrrrrrrrrrr++++++++rrrrr++++++
++++++++++++++++++++++++++++++++++++++++++++++++++++++++++++++++++++++++++++++++++++++++++++++++++
++++++++++++++++++++++++++++++++++++++++++++++++++++++++++++++++++++++++++++++++++++++++++++++++++
++++++++++++++++++++++++++++++++++++++++++++++++++++++++++++++++++++++++++++++++++++++++++++++++++