++++++++++++++++++++++++++++++++++++++++++++++++++
++++++++++++++++++++++++++++++++++++++++++++++++++
++++++++++++++++++++++++++++++++++++++++++++++++++
++++++++++++rrrrrrr++++++++++++rrrrrrr++++++++++++
+++++++++++r+++++2r+++++++++++r++++++r++++++++++++
++++++++++r+++++++r++++++++++r+++2+++r++++++++++++
+++++++++r++++++++r+++++++++r++++++++r++++++++++++
++++++++r++S++++++r++++++++r+++++++++r++++++++++++
+++++++r+M++++++++r+++++++r^^^rr++1++r++++++++++++
++++++rrrrrrr+++++r++++++rOOOr+r+++++r++++++++++++
++++++++++++r++1++r+++++rOOOr++r+++++r++++++++++++
++++++++++++r+++++r++++r^^^rrrrrr++++rrrrrrrrrrrrr
++++++++++++r+++++r+++r++++++++++r+++++++E++++++++
++++++++++++r1+++1r++r++++3+++++++r++++++EM+++++++
++++++++++++r+++++r2r+++++++++++2++r+++++E++++++++
++++++++++++r+++++rrrrrrrrrrrrrr++++rrrrrrrrrrrrrr
++++++++++++r++1++r++++++++++++r+++++r++++++++++++
++++++++++++r+++++r++++++++++++rOOOOOr++++++++++++
++++++++++++r+++++r++++++++++++rOOOOOr++++++++++++
++++++++++++r++3++r++++++++++++rIIIIIr++++++++++++
++++++++++++r+++++r++++++++++++rIIIIIr++++++++++++
++++++++++++r++3++r++++++++++++rIIIIIr++++++++++++
++++++rrrrrrr+++++rrrrrrrrrrrrrrIIIIIr++++++++++++
++++++r++++++++++++++++++++++++++++++r++++++++++++
++++++r+&++++++++++++++++++++++++++++r++++++++++++
++++++r4++++3++1++3++2++1++2++1++++++r++++++++++++
++++++r+&++++++++++++++++++++++++++++r++++++++++++
++++++r++++++++++++++++++++++++++++++r++++++++++++
++++++rrrrrrrrrrrrrrrrrrrrrrrrrrrrrrrr++++++++++++
++++++++++++++++++++++++++++++++++++++++++++++++++
++++++++++++++++++++++++++++++++++++++++++++++++++
++++++++++++++++++++++++++++++++++++++++++++++++++