+++++++++++++++++++T++++++++++++++++++++++++T+++++++++++++++++
++++++++++++++T++++++++T++++++++++T+++++++++++++++++++++++++++
++++++++++T+++++++++++++++++T+++++++++++T+++++++++++++++++++++
++++++rrrrrrrrrrrrrrrr++rrrrrrrrrrrrr++rrrrrr+++++++++++++++++
++++++r+++++++++++++++++++++++O++++++++++++++T++++++++++++++++
++++++r+++++++++++++++R+++++++O++++++R++++++++T+++++++++++++++
++++++r++++++++12+++++r+++3+++O+++3++r+++++++++T++r+++++++++++
++++++r+++++++++++++++++++++++O+++++++++++++++++T++++T++++++++
++++++r+++M+++++++++++++++++++O++++++++++++++++++T++++++++++++
++++++r+S+++++rrr+++++12+++++rrr+++++1+++++2++++++T+++T+++++++
++++++r++++++++O+++++++++++++++++++++++++++++++++++T++++++++++
++++++r++++++++O++++++++++++++++++++++++++++++++++++T+++++++++
++++++r+++3++++O+++3++r+++++++12+++++r+++++2++++2++++T++++++++
++++++r++++++++O++++++++++++++++++++++++++++++++++++++T+++++++
++++++r++++++++O++++++R++++++++++++++R+++++++++++++++++T++++++
++++++rrrrrrrrrrrrrrrr++rrrrrrrrrrrrr++rrrrrrr+++++++++r++++++
+++++++++++++++++++++++++++++++++++++++++++++r++IIIII++r++++++
+++++++++++++++++++++++++++++++++++++++++++++rI1IIIII1Ir++++++
+++++++++++++++++++++++++++++++++++++++++++++rIIIIIIIIIr++++++
+++++++++++++++++++++++++++++++++++++++++++++rIIIIIIIIIr++++++
+++++++++++++++++++++++++++++++++++++++++++++rIIIIIIIIIr++++++
+++++++++++++++++++++++++++++++++++++++++++++rIIIIIIIIIr++++++
+++++++++++++++++++++++++++++++++++++++++++++rOOOO1OOOOr++++++
+++++++++++++++++++++++++++++++++++++++++++++r^^^^^^^^^r++++++
+++++++++++++++++++++++++++++++++++++++++++++r+++++++++r++++++
+++++++++++++++++++++++++++++++++++++++++++++r+++++++++r++++++
+++++++++++++++++++++++++++++++++++++++++++++r+++++++++r++++++
+++++++++++++++++++++++++++++++++++++++++++++r+1++4++1+r++++++
+++++++++++++++++++++++++++++++++++++++++++++r+++++++++r++++++
++++++++++++rrrrrrrrrr++rrrrrrrrrrrrr++rrrrrrr+++++++++r++++++
+++++++++++r++++O++++++++++++++++++++++++++++++++++++++T++++++
++++++++++r+++++O+++++R++++++++++++++R++++++++++++++++T+++++++
+++++++++r+++++1O2++++r+++++++1+++++++++++++++++2++++T++++++++
rrrrrrrrrr++++++O+++++++++++++2++++++R++++++++++++++T+++++++++
+++++++++E++++++O++++++++++++++++++++OO++++++++++++T++++++++++
++++++++M+E+++rrr++++31++++++rrr+++3+OO+++2+++++++T+++++++++++
+++++++++E++++++O++++++++++++++++++++OO++++++++++T++++++++++++
rrrrrrrrrr++++++O+++++++++++++2+++++++++++++++++T++++r++++++++
+++++++++r+++++1O2++++r+++++++1++++++R+++++++++T++++++++++++++
++++++++++r+++++O+++++++++++++++++++++++++++++T+++++++++++++++
+++++++++++r++++O+++++R++++++++++++++R+++++++T++++++++++++++++
++++++++++++rrrrrrrrrr++rrrrrrrrrrrrr++rrrrrr+++++rR++++++++++
+++++++++++++++++++T++++++++++++++++++++++++T+++++++++++++++++
++++++++++++++T++++++++T++++++++++T+++++++++++++++++++++++++++
++++++++++T+++++++++++++++++T+++++++++++T+++++++++++++++++++++