+++++++++++++T++++++++++++++++++++++++++++++++++++++++++++++++++++++++++++++++++++++++++++++
++++++++T++++++++T++++++++++++++++++++++++++++++++++++++++++++++++++++++++++++++++++++++++++
++++T+++++++++++++++++T+++++++++++++++++++++++++++++++++++++++++++++++++++++++++++++++++++++
+++++++++++++++++++++++++++++++++++++++++++++rr+++++++++++++++++++++++++++++++++++++++++++++
++++++++++++++++++++++++++++++++++++++++++++r++r++++++++++++++++++++++++++++++++++++++++++++
+++++++++++++++++++++++++++++++++++++++++++r++++r+++++++++++++++++++++++++++++++++++++++++++
++++++++++++++++++++++++++++++++++++++++++r+M++S+r++++++++++++++++++++++++++++++++++++++++++
+++++++++++++++++++++++++++++++++++++++++r++++++++r+++++++++++++++++++++++++++++++++++++++++
++++++++++++++++++++++++++++++++++++++++r++++++++++r++++++++++++++++++++++++++++++++++++++++
++T++++++++++++++++++++++++++++++++++++r++++++++++&+r+++++++++++++++++++++++++++++++++++++++
++++++++++++++++++++++++++++++++++++++r++3++rrrrrrrrrr++++++++++++++++++++++++++++++++++++++
+++++++++++++++++++++++++++++++++++++r++++++++++++++++r+++++++++++++++++++++++++++++++++++++
+r++++++++++++++++++++++++++++++++++r++++1+++++++++2+++r++++++++++++++++++++++++++++++++++++
+++++++++++++++++++++++++++++++++++r++++++++++++++++++&+r+++++++++++++++++++++++++++++++++++
++T+++++++++++++++++++++++++++++++rrrrrrrrrrrrrrr++3++rrrr++++++++++++++++++++++++++++++++++
+++++++++++++++++++++++++++++++++r+++^^^^++++++^^+++++++++r+++++++++++++++++++++++++++++++++
++++++++++++++++++++++++++++++++r++++^^^^++++^^^^++1+++++++r++++++++++++++++++++++++++++++++
+T+++++++++++++++++++++++++++++r+++++^^++++++^^^^+++++++++&+r+++++++++++++++++++++++++++++++
+++++T++++++++++++++++++++++++r++3++rrrrrrrrrrrrrrrrrrrrrrrrrr++++++++++++++++++++++++++++++
+++++++++++++++++++++++++++++r+++++++IIIIOO+++++++++++++++++++r+++++++++++++++++++++++++++++
++++++++++++++++++++++++++++r++++1+++IIIIOO+2++++2+++++++++2+++r++++++++++++++++++++++++++++
++T++++++++++++++++++++++++r+++++++++IIIIOO+++++++++++++++++++&+r+++++++++++++++++++++++++++
++++++++++++++++++++++++++rrrrrrrrrrrrrrrrrrrrrrrrrrrrrrr++3++rrrr++++++++++++++++++++++++++
+++++++++++++++++++++++++r++++++++++++++++++++O+++++++++++++++++++r+++++++++++++++++++++++++
+r++++++++++++++++++++++r++++++++++++++++++++4^^^^+++++++++1+++++++r++++++++++++++++++++++++
+++++++++++++++++++++++r++++++++++++++++++++++O+++++++++++++++++++&+r+++++++++++++++++++++++
++T+++++++++++++++++++r++3++rrrrrrrrrrrrrrrrrrrrrrrrrrrrrrrrrrrrrrrrrr++++++++++++++++++++++
+++++++++++++++++++++r++++++++++++++++++++++3+++++++++++++++++++++++++r+++++++++++++++++++++
++++++++++++++++++++r++++1+++++++++++++++++++++++++++++++++++++++++2+++r++++++++++++++++++++
+T+++++++++++++++++r++++++++++++++3+++++++++++++++++++3+++++++++++++++&+r+++++++++++++++++++
++++++++++++++++++rrrrrrrrrrrrrrrrrrrrrrrrrrrrrrrrrrrrrrrrrrrrrrr++3++rrrr++++++++++++++++++
+++++++++++++++++r++++++IIIIIIIIIIIIIIIIIIIIIIIIIIIIIIIIIIII++++++++++++++r+++++++++++++++++
++T+++++++++++++r+++++++III2IIIIII1IIIIII1IIIIII1IIIIII2IIII+++++++1+++++++r++++++++++++++++
+++++++++++++++r++++++++IIIIIIIIIIIIIIIIIIIIIIIIIIIIIIIIIIII++++++++++++++&+r+++++++++++++++
++++++++++++++r++3++rrrrrrrrrrrrrrrrrrrrrrrrrrrrrrrrrrrrrrrrrrrrrrrrrrrrrrrrrr++++++++++++++
+r+++++++++++r++++++^OIIIIIIIIIO^+++++++++++++++++++^OIIIIIIIIIO^+++++++++++++r+++++++++++++
++++++++++++r++++1+++^OIIIIIIIO^+++++++++++++++++++++^OIIIIIIIO^+++3+++++++3+++r++++++++++++
++T++++++++r^+++++++++^OIIIIIO^++++2++++^^^^^++++2++++^OIIIIIO^++++++++++++++++&+r++++++++++
++++++++++rIO^+++++++++^OOOOO^+++++++++^OOOOO^+++++++++^OOOOO^+++++++++++++++EEE+r++++++++++
+++++++++rIIIO^++++2++++^^^^^++++2++++^OIIIIIO^++++2++++^^^^^++++2++++^^^^^^^^^ME^r+++++++++
+T++++++rIIIIIO^+++++++++++++++++++++^OIIIIIIIO^+++++++++++++++++++++^OIIIIIIIO^^^^r++++++++
+++++T+rIIIIIIIO^+++++++++++++++++++^OIIIIIIIIIO^+++++++++++++++++++^OIIIIIIIIIO^^&+r+++++++
++++++rrrrrrrrrrrrrrrrrrrrrrrrrrrrrrrrrrrrrrrrrrrrrrrrrrrrrrrrrrrrrrrrrrrrrrrrrrrrrrrr++++++
+++++++++++++T++++++++++++++++++++++++++r++++++++++r++++++++++++++++++++++++++++++++++++++++
+++++++++++++++++++++++++++++++++++++++r+++++++r++++++++++++++++++++++++++++++++++++++++++++
+++++++++++++++++++++++++++++++++++++++++++++++++++r++++++++++++++++++++++++++++++++++++++++