++++++++++++++++++++++++++++
++++++++++++++++++++++++++++
++++++++++++++++++++++++++++
+++++++rrrrrrrrrr+++++++++++
+++++++r+M+S++++r+++++++++++
+++++++r++++++++r+++++++++++
+++++++r++++++++r+++++++++++
+++++++r3IIIIII3r+++++++++++
+++++++r3IIIIII3r+++++++++++
+++++++r3IIIIII3r+++++++++++
+++++++r3IIIIII3r+++++++++++
+++++++r3IIIIII3r+++++++++++
++++++++r3IIIIII3r++++++++++
++++++++r3IIIIII3r++++++++++
++++++++r3IIIIII3r++++++++++
++++++++r3IIIIII3r++++++++++
++++++++r3IIIIII3r++++++++++
+++++++r3IIIIII3r+++++++++++
+++++++r3IIIIII3r+++++++++++
+++++++r3IIIIII3r+++++++++++
+++++++r3IIIIII3r+++++++++++
+++++++r3IIIIII3r+++++++++++
++++++++r3IIIIII3r++++++++++
++++++++r3IIIIII3r++++++++++
++++++++r3IIIIII3r++++++++++
++++++++r3IIIIII3r++++++++++
++++++++r3IIIIII3r++++++++++
+++++++++r3IIIIII3r+++++++++
+++++++++r3IIIIII3r+++++++++
+++++++++r3IIIIII3r+++++++++
+++++++++r3IIIIII3r+++++++++
+++++++++r3IIIIII3r+++++++++
++++++++++r3IIIIII3r++++++++
++++++++++r3IIIIII3r++++++++
++++++++++r3IIIIII3r++++++++
++++++++++r3IIIIII3r++++++++
++++++++++r3IIIIII3r++++++++
+++++++++++r3IIIIII3r+++++++
+++++++++++r3IIIIII3r+++++++
+++++++++++r3IIIIII3r+++++++
+++++++++++r3IIIIII3r+++++++
+++++++++++r3IIIIII3r+++++++
++++++++++r3IIIIII3r++++++++
++++++++++r3IIIIII3r++++++++
++++++++++r3IIIIII3r++++++++
++++++++++r3IIIIII3r++++++++
++++++++++r3IIIIII3r++++++++
+++++++++r3IIIIII3r+++++++++
+++++++++r3IIIIII3r+++++++++
+++++++++r3IIIIII3r+++++++++
+++++++++r3IIIIII3r+++++++++
+++++++++r3IIIIII3r+++++++++
++++++++r3IIIIII3r++++++++++
++++++++r3IIIIII3r++++++++++
++++++++r3IIIIII3r++++++++++
++++++++r3IIIIII3r++++++++++
++++++++r3IIIIII3r++++++++++
+++++++r3IIIIII3r+++++++++++
+++++++r3IIIIII3r+++++++++++
+++++++r3IIIIII3r+++++++++++
+++++++r3IIIIII3r+++++++++++
+++++++r3IIIIII3r+++++++++++
+++++++r++++++++r+++++++++++
+++++++rEEEEEEEEr+++++++++++
+++++++r++M+++++r+++++++++++
+++++++r++++++++r+++++++++++
+++++++r++++++++r+++++++++++
+++++++r++++++++r+++++++++++