++++++++++++++++++++++++++++++++++++++++++++++++++++++++++++++++++++++++++++++++++
++++++++++++++++++++++++++++++++++++++++++++++++++++++++++++++++++++++++++++++++++
++++++++++++++++++++++++++++++++++++++++++++++++++++++++++++++++++++++++++++++++++
+++++++++rrrrrrrrrrrrrrr+++rrrrrrrrrrrrr++++++rrrrrrrrrrrrrrrrrrrrrrrrrr++++++++++
++++++++r+++++++rr+++++r+++r++++++++++++rrr+++r+++++++++++++++++++++++++r+++++++++
+++++++r+++++S+Mrr++++&r+++r++2+++++3++++++rr+r+2+++++2+++++2++++++++++++r++++++++
++++++r+++++++++rr+++++r+++r+++++++++++++++++rr+++++++++++++++++++++++++++r+++++++
++++++r+++++rrrrrr^+r^+r+++rOOOOOrrrrrR2+++++rrrrrrr+++++rrrrrrr+++1+++1+++r++++++
++++++r^^^^^r++++r^+r^+r+++rO+++Orr++++++++++r+++++r+++++r+++++r+++++++++++r++++++
++++++r+++++r++++r^+r^+r+++rO+++Orr++++++++rr++++++r+++++r+++++r+++++3+++++r++++++
++++++r++1++r++++r^+r^+r+++rOOOOOrr+1+++rrr++++++++r+++++r+++++r+++++++++++r++++++
++++++r+++++r++++r^+r^+r+++rIIO++rr++++r+++++++++++r+++++r+++++r+++++++++++r++++++
++++++r++3++r++++r^+r^+r+++rIIO++rr++++r+++++++++++r++2++r+++++r+++1+2+1+++r++++++
++++++r+++++r++++r^+r^+r+++rOOOOOrr++++r+++++++++++r+++++r+++++r+++++++++++r++++++
++++++r++3++r++++r^+r^+r+++rO+++Orr++++r+++++++++++r+++++r+++++r+++++++++++r++++++
++++++r+++++r++++r^+r^+r+++rO+++Orr++++r+++++++++++r+++++r+++++r+++++3+++++r++++++
++++++r++1++rrrrrr^+r^++rrrOOOOOOrr++1+rrrrrrrrrrrrr+++++rrrrrrr+++1+++1+++r++++++
++++++r+++++++++++++r++++++++++++rr+++++++++++++++++++++++++++rr++++++++++r+++++++
+++++++r++++2+++rOOOr++++4+++++++rr+4+++++2+++++2+++++2+++++2+rrEE+++++++r++++++++
++++++++r+++++++rrO&r+++++++++&+r+r+++++++++++++++++++++++++++rrME++++++r+++++++++
+++++++++rrrrrrrr+rrrrrrrrrrrrrr++rrrrrrrrrrrrrrrrrrrrrrrrrrrrrrrrrrrrrr++++++++++
++++++++++++++++++++++++++++++++++++++++++++++++++++++++++++++++++++++++++++++++++
++++++++++++++++++++++++++++++++++++++++++++++++++++++++++++++++++++++++++++++++++
++++++++++++++++++++++++++++++++++++++++++++++++++++++++++++++++++++++++++++++++++