IIIIIIIIIIIIIIIIIIIIIIIIIIIIIIIIIIIIIIIIIIIIIIIIIIIIIIIIIIIIIIIIIIIIIIIIIIIII
IIIIIIIIIIIIIIIIIIIIIIIIIIIIIIIIIIIIIIIIIIIIIIIIIIIIIIIIIIIIIIIIIIIIIIIIIIIII
IIIIIIIIIIIIIIIIIIIIIIIIIIIIIIIIIIIIIIIIIIIIIIIIIIIIIIIIIIIIIIIIIIIIIIIIIIIII
IIIIIIrrrrrrrrrrrrrrrrrrrrrrrrrrrrrrrrrrrrrrrrrrrrrrrrrrrrrrrrrrrrrrrrrIIIIII
IIIIIIrIIIIIIIIIIII1IIIIIIIIIII1IIIIIIIIIII1IIIIIIIIIII1IIIIIIIIIIIrIIrIIIIII
IIIIIIrIIMISIIIIIIIIIIIIIIIIIIIIIIIIIIIIIIIIIIIIIIIIIIIIIIIIIIIIIIIrIIrIIIIII
IIIIIIrIIIIIIIIIIIIII3IIIIIIIIIII3IIIIIIIIIII3IIIIIIIIIII3IIIIIIIIIrIIrIIIIII
IIIIIIrIIIIIIIIIIIIIIIIIIIIIIIIIIIIIIIIIIIIIIIIIIIIIIIIIIIIIIIIIIIIrIIrIIIIII
IIIIIIrIIIIIIIIIIIIIIII2IIIIIIIIIII2IIIIIIIIIII2IIIIIIIIIII2IIIIIIIrIIrIIIIII
IIIIIIrIIIIIIIIIIIIIIIIIIIIIIIIIIIIIIIIIIIIIIIIIIIIIIIIIIIIIIIIIIIIrIIrIIIIII
IIIIIIrIIIIII1IIIIIIIIIII1IIIIIIIIIII1IIIIIIIIIII1IIIIIIIIIII1IIIIIrIIrIIIIII
IIIIIIrIIIIIIIIIIIIIIIIIIIIIIIIIIIIIIIIIIIIIIIIIIIIIIIIIIIIIIIIIIIIrIIrIIIIII
IIIIIIrIIIIIIII3IIIIIIIIIII3IIIIIIIIIII3IIIIIIIIIII3IIIIIIIIIII3IIIrIIrIIIIII
IIIIIIrIIIIIIIIIIIIIIIIIIIIIIIIIIIIIIIIIIIIIIIIIIIIIIIIIIIIIIIIIIIIrIIrIIIIII
IIIIIIrIIIIIIIIII2IIIIIIIIIII2IIIIIIIIIII2IIIIIIIIIII2IIIIIIIIIII2IrIIrIIIIII
IIIIIIrIIIIIIIIIIIIIIIIIIIIIIIIIIIIIIIIIIIIIIIIIIIIIIIIIIIIIIIIIIIIrIIrIIIIII
IIIIIIr1IIIIIIIIIII1IIIIIIIIIII1IIIIIIIIIII1IIIIIIIIIII1IIIIIIIIIIIrIIrIIIIII
IIIIIIrIIIIIIIIIIIIIIIIIIIIIIIIIIIIIIIIIIIIIIIIIIIIIIIIIIIIIIIIIIIIrIIrIIIIII
IIIIIIrII3IIIIIIIIIII3IIIIIIIIIII3IIIIIIIIIII3IIIIIIIIIII3IIIIIIIIIrIIrIIIIII
IIIIIIrIIIIIIIIIIIIIIIIIIIIIIIIIIIIIIIIIIIIIIIIIIIIIIIIIIIIIIIIIIIIrIIrIIIIII
IIIIIIrIIII2IIIIIIIIIII2IIIIIIIIIII2IIIIIIIIIII2IIIIIIIIIII2IIIIIIIrIIrIIIIII
IIIIIIrIIIIIIIIIIIIIIIIIIIIIIIIIIIIIIIIIIIIIIIIIIIIIIIIIIIIIIIIIIIIrIIrIIIIII
IIIIIIrIIIIII1IIIIIIIIIII1IIIIIIIIIII1IIIIIIIIIII1IIIIIIIIIII1IIIIIrIIrIIIIII
IIIIIIrIIIIIIIIIIIIIIIIIIIIIIIIIIIIIIIIIIIIIIIIIIIIIIIIIIIIIIIIIIIIrIIrIIIIII
IIIIIIrIIIIIIII3IIIIIIIIIII3IIIIIIIIIII3IIIIIIIIIII3IIIIIIIIIII3IIIrIIrIIIIII
IIIIIIrIIIIIIIIIIIIIIIIIIIIIIIIIIIIIIIIIIIIIIIIIIIIIIIIIIIIIIIIIIIIrIIrIIIIII
IIIIIIrIIIIIIIIII2IIIIIIIIIII2IIIIIIIIIII2IIIIIIIIIII2IIIIIIIIIII2IrIIrIIIIII
IIIIIIrIIIIIIIIIIIIIIIIIIIIIIIIIIIIIIIIIIIIIIIIIIIIIIIIIIIIIIIIIIIIrIIrIIIIII
IIIIIIr1IIIIIIIIIII1IIIIIIIIIII1IIIIIIIIIII1IIIIIIIIIII1IIIIIIIIIIIrIIrIIIIII
IIIIIIrIIIIIIIIIIIIIIIIIIIIIIIIIIIIIIIIIIIIIIIIIIIIIIIIIIIIIIIIIIIIrIIrIIIIII
IIIIIIrII3IIIIIIIIIII3IIIIIIIIIII3IIIIIIIIIII3IIIIIIIIIII3IIIIIIIIIrIIrIIIIII
IIIIIIrIIIIIIIIIIIIIIIIIIIIIIIIIIIIIIIIIIIIIIIIIIIIIIIIIIIIIIIIIIIIrIIrIIIIII
IIIIIIrIIII2IIIIIIIIIII2IIIIIIIIIII2IIIIIIIIIII2IIIIIIIIIII2IIIIIIIrIIrIIIIII
IIIIIIrIIIIIIIIIIIIIIIIIIIIIIIIIIIIIIIIIIIIIIIIIIIIIIIIIIIIIIIIIIIIrIIrIIIIII
IIIIIIrIIIIII1IIIIIIIIIII1IIIIIIIIIII1IIIIIIIIIII1IIIIIIIIIII1IIIIIIIIrIIIIII
IIIIIIrIIIIIIIIIIIIIIIIIIIIIIIIIIIIIIIIIIIIIIIIIIIIIIIIIIIIIIIIIIIIIIIrIIIIII
IIIIIIrIIIIIIII3IIIIIIIIIII3IIIIIIIIIII3IIIIIIIIIII3IIIIIIIIIII3IIIIIIrIIIIII
IIIIIIrIIIIIIIIIIIIIIIIIIIIIIIIIIIIIIIIIIIIIIIIIIIIIIIIIIIIIIIIIIIIIIIrIIIIII
IIIIIIrIIIIIIIIII2IIIIIIIIIII2IIIIIIIIIII2IIIIIIIIIII2IIIIIIIIIII2IIIIrIIIIII
IIIIIIrIIIIIIIIIIIIIIIIIIIIIIIIIIIIIIIIIIIIIIIIIIIIIIIIIIIIIIIIIIIIrIIrIIIIII
IIIIIIr1IIIIIIIIIII1IIIIIIIIIII1IIIIIIIIIII1IIIIIIIIIII1IIIIIIIIIIIrIIrIIIIII
IIIIIIrIIIIIIIIIIIIIIIIIIIIIIIIIIIIIIIIIIIIIIIIIIIIIIIIIIIIIIIIIIIIrIIrIIIIII
IIIIIIrII3IIIIIIIIIII3IIIIIIIIIII3IIIIIIIIIII3IIIIIIIIIII3IIIIIIIIIrIIrIIIIII
IIIIIIrIIIIIIIIIIIIIIIIIIIIIIIIIIIIIIIIIIIIIIIIIIIIIIIIIIIIIIIIIIIIrIIrIIIIII
IIIIIIrIIII2IIIIIIIIIII2IIIIIIIIIII2IIIIIIIIIII2IIIIIIIIIII2IIIIIIIrIIrIIIIII
IIIIIIrIIIIIIIIIIIIIIIIIIIIIIIIIIIIIIIIIIIIIIIIIIIIIIIIIIIIIIIIIIIIrIIrIIIIII
IIIIIIrIIIIII1IIIIIIIIIII1IIIIIIIIIII1IIIIIIIIIII1IIIIIIIIIII1IIIIIrIIrIIIIII
IIIIIIrIIIIIIIIIIIIIIIIIIIIIIIIIIIIIIIIIIIIIIIIIIIIIIIIIIIIIIIIIIIIrIIrIIIIII
IIIIIIrIIIIIIII3IIIIIIIIIII3IIIIIIIIIII3IIIIIIIIIII3IIIIIIIIIII3IIIrIIrIIIIII
IIIIIIrIIIIIIIIIIIIIIIIIIIIIIIIIIIIIIIIIIIIIIIIIIIIIIIIIIIIIIIIIIIIrIIrIIIIII
IIIIIIrIIIIIIIIII2IIIIIIIIIII2IIIIIIIIIII2IIIIIIIIIII2IIIIIIIIIII2IrIIrIIIIII
IIIIIIrIIIIIIIIIIIIIIIIIIIIIIIIIIIIIIIIIIIIIIIIIIIIIIIIIIIIIIIIIIIIrIIrIIIIII
IIIIIIr1IIIIIIIIIII1IIIIIIIIIII1IIIIIIIIIII1IIIIIIIIIII1IIIIIIIIIIIrIIrIIIIII
IIIIIIrIIIIIIIIIIIIIIIIIIIIIIIIIIIIIIIIIIIIIIIIIIIIIIIIIIIIIIIIIIIIrIIrIIIIII
IIIIIIrII3IIIIIIIIIII3IIIIIIIIIII3IIIIIIIIIII3IIIIIIIIIII3IIIIIIIIIrIIrIIIIII
IIIIIIrIIIIIIIIIIIIIIIIIIIIIIIIIIIIIIIIIIIIIIIIIIIIIIIIIIIIIIIIIIIIrIIrIIIIII
IIIIIIrIIII2IIIIIIIIIII2IIIIIIIIIII2IIIIIIIIIII2IIIIIIIIIII2IIIIIIIrIIrIIIIII
IIIIIIrIIIIIIIIIIIIIIIIIIIIIIIIIIIIIIIIIIIIIIIIIIIIIIIIIIIIIIIIIIIIrIIrIIIIII
IIIIIIrIIIIII1IIIIIIIIIII1IIIIIIIIIII1IIIIIIIIIII1IIIIIIIIIII1IIIIIrIIrIIIIII
IIIIIIrIIIIIIIIIIIIIIIIIIIIIIIIIIIIIIIIIIIIIIIIIIIIIIIIIIIIIIIIIIIIrIIrIIIIII
IIIIIIrIIIIIIII3IIIIIIIIIII3IIIIIIIIIII3IIIIIIIIIII3IIIIIIIIIII3IIIrIIrIIIIII
IIIIIIrIIIIIIIIIIIIIIIIIIIIIIIIIIIIIIIIIIIIIIIIIIIIIIIIIIIIIIIIIIIIrIIrIIIIII
IIIIIIrIIIIIIIIII2IIIIIIIIIII2IIIIIIIIIII2IIIIIIIIIII2IIIIIIIIIII2IrIIrIIIIII
IIIIIIrIIIIIIIIIIIIIIIIIIIIIIIIIIIIIIIIIIIIIIIIIIIIIIIIIIIIIIIIIIIIrIIrIIIIII
IIIIIIrrrrrrrrrrrrrrrrrrrrrrrrrrrrrrrIIIIIIrrrrrrrrrrrrrrrrrrrrrrrrrIErIIIIII
IIIIIIrIIIIIIIIIIIIIIIIIIIIIIIIIIIIIIIIIIIIIIIIIIIIIIIIIIIIIIIIIIIIIEErIIIIII
IIIIIIrIIIIIIIIIIIIIIIIIIIIIIIIIIIIIIIIIIIIIIIIIIIIIIIIIIIIIIIIIIIIEEMrIIIIII
IIIIIIrrrrrrrrrrrrrrrrrrrrrrrrrrrrrrrrrrrrrrrrrrrrrrrrrrrrrrrrrrrrrrrrrIIIIII
IIIIIIIIIIIIIIIIIIIIIIIIIIIIIIIIIIIIIIIIIIIIIIIIIIIIIIIIIIIIIIIIIIIIIIIIIIIII
IIIIIIIIIIIIIIIIIIIIIIIIIIIIIIIIIIIIIIIIIIIIIIIIIIIIIIIIIIIIIIIIIIIIIIIIIIIII
IIIIIIIIIIIIIIIIIIIIIIIIIIIIIIIIIIIIIIIIIIIIIIIIIIIIIIIIIIIIIIIIIIIIIIIIIIIII