+++++++++++++T++++++++++++++++++++++++++r++++++++++r++++++++++++++++++++++++++++++++++++++++
++++++++T++++++++T++++++++++++++++++++++r++++++++++r++++++++++++++++++++++++++++++++++++++++
++++T+++++++++++++++++T+++++++++++++++++r++++M+++++r++++++++++++++++++++++++++++++++++++++++
++++++++++++++++++++++++++++++++++++++++rEEEEEEEEEEr++++++++++++++++++++++++++++++++++++++++
++T++++++++++++++++++++++++++++++++++++r++++++++++++r+++++++++++++++++++++++++++++++++++++++
++++++++++++++++++++++++++++++++++++++r++++++++++++++r++++++++++++++++++++++++++++++++++++++
+++++++++++++++++++++++++++++++++++++r++++++++++++++++r+++++++++++++++++++++++++++++++++++++
+r++++++++++++++++++++++++++++++++++r++++++++++++++++++r++++++++++++++++++++++++++++++++++++
+++++++++++++++++++++++++++++++++++r++++++++++++++++++++r+++++++++++++++++++++++++++++++++++
++T+++++++++++++++++++++++++++++++r+++++++rrrrrrrrrrrrrrrr++++++++++++++++++++++++++++++++++
+++++++++++++++++++++++++++++++++r++++++++++++++++++++++++r+++++++++++++++++++++++++++++++++
++++++++++++++++++++++++++++++++r+++++++++&&&&&&&&&&&&&&+++r++++++++++++++++++++++++++++++++
+T+++++++++++++++++++++++++++++r++++++++++++++++++++++++++++r+++++++++++++++++++++++++++++++
+++++T++++++++++++++++++++++++r++++++++++++++++++++++++++++++r++++++++++++++++++++++++++++++
+++++++++++++++++++++++++++++r++++++++++++++++++++++++++++++++r+++++++++++++++++++++++++++++
++++++++++++++++++++++++++++rrrrrrrrrrrrrrrrrrrrrrrrrrrr+++++++r++++++++++++++++++++++++++++
++T++++++++++++++++++++++++r++++++++++++++++++++++++++++++++++++r+++++++++++++++++++++++++++
++++++++++++++++++++++++++r++++++++++++++++++++++++++++++++++++&+r++++++++++++++++++++++++++
+++++++++++++++++++++++++r+++++++^^^^^^^^^^^^^^^^^^^^^^^^^^+++++++r+++++++++++++++++++++++++
+r++++++++++++++++++++++r++++++++^^^^^^^^^^^^^^^^^^^^^^^^^^++++++++r++++++++++++++++++++++++
+++++++++++++++++++++++r++++++++++++++++++++++++++++++++++++++++++++r+++++++++++++++++++++++
++T+++++++++++++++++++r++++++++++++++++++++++++++++++++++++++++++++&+r++++++++++++++++++++++
+++++++++++++++++++++r++++++rrrrrrrrrrrrrrrrrrrrrrrrrrrrrrrrrrrrrrrrrrr+++++++++++++++++++++
++++++++++++++++++++r+++++++++++++^+++++++^+++++++^++++++++++++++++++++r++++++++++++++++++++
+T+++++++++++++++++r++++++++++++++++++++++++++++++++++++++++++++++++++++r+++++++++++++++++++
++++++++++++++++++r+++++++++++^+++++++^+++++++^+++++++^++++++++++++++++++r++++++++++++++++++
+++++++++++++++++rrrrrrrrrrrrrrrrrrrrrrrrrrrrrrrrrrrrrrrrr++++++++++++++++r+++++++++++++++++
++T+++++++++++++r+++++^+++++++++++++++r+++++++++^+++++++++r++++++++++++++++r++++++++++++++++
+++++++++++++++r++++++^++++++++++++++r++++++++++^++++++++++r++++++++++++++++r+++++++++++++++
++++++++++++++r+++++++^++++++++&++++r+&+++++++++^+++++++++++r++++++++++++++++r++++++++++++++
+r+++++++++++r++++++++r++++++++++++r++++++++++++r++++++++++++r++++++++++++++++r+++++++++++++
++++++++++++r++++++++r++++++++++++r++++++++++++r++++++++++++++r++++++++++++++++r++++++++++++
++T++++++++r++++++++r++++++++++++r++++++++++++r++++++++++++++++r++++++++++++++++r+++++++++++
++++++++++r++++++++r++++++++++++r++++++++++++r++++++++++++++++++r++++++++++++++++r++++++++++
+++++++++r++++++++r+++++++++++++^+++++++++++r+++++++++++++++++++^+++++++++++++++++r+++++++++
+T++++++r++++++++r++++++++++++++^++++++++++r++++++++++++++++++++^++++++++++++++++&+r++++++++
+++++T+r+M+S++++r++++++&++++++++^+++++++++r+++++++++++++++++++++^+++++++++++++++++&+r+++++++
++++++rrrrrrrrrrrrrrrrrrrrrrrrrrrrrrrrrrrrrrrrrrrrrrrrrrrrrrrrrrrrrrrrrrrrrrrrrrrrr&rr++++++
+++++++++++++T++++++++++++++++++++++++++r++++++++++r++++++++++++++++++++++++++++++rrr+++++++
+++++++++++++++++++++++++++++++++++++++r+++++++r++++++++++++++++++++++++++++++++++++++++++++
+++++++++++++++++++++++++++++++++++++++++++++++++++r++++++++++++++++++++++++++++++++++++++++