+++++++++++++T++++++++++++++++++++++++++++++++++++++++++++++++++++++++++++++++++++++++++++++++++++++++++++++++++++++++++++++++++++++++++++++++++++++++++++++
++++++++++++++++++++++++++++++++++++++++++++++++++++++++++++++++++++++++++++++++++++++++++++++++++++++++++++++++++++++++++++++++++++++++++++++++++++++++++++
++++++++++++++++++++++++++++++++++++++++++++++++++++++++++++++++++++++++++++++++++++++++++++++++++++++++++++++++++++++++++++++++++++++++++++++++++++++++++++
++++++++++++++++++++++++++++++++++++++++++++++++++++++++++++++++++++++++++++++++++++++++++++++++++++++++++++++++++++++++++++++++++++++++++++++++++++++++++++
++++++++++++++++++++++++++++++++++++++++++++++++++++++++++++++++++++++++++++++++++++++++++++++++++++++++++++++++++++++++++++++++++++++++++++++++++++++++++++
++++++++++++++++++++++++++++++++rrrrrrrrrrrrrr++++++++++++++++rrrrrrrrrrrrrrrrrrrrrrrrrrrrrrrrrrrrrrrrrrrrrrrrrrrrrrrrrrrrrrrrrrrrrrrrrrrrrrrr++++++++++++++
++++++++++++++++++++++++++++++++r++++++++++++r++++++++++++++++r++++++++++++++++++++++++++++++++++++++++++++++r++++++++++++++++++3++++++++++++r++++++++++++++
++++++++++++++++++++++++++++++++rr+M+++S++++rr++++++++++++++++rr++++++++++rr+++++++++++++++++++++++++++++++++r++++++++++++++++++++++++3++++++r++++++++++++++
+++++++++++++++++++++++++++++++++r++++++++++r++++++++++++++++++r++++++++++r+r+5++++1++1++1+1+++++++1+++1++++1r1+++++++++++++++++4++++++++++++r++++++++++++++
+++++++++++++++++++++++++++++++++r++++++++++r++++++++++++++++++r+++++++++&r++r+++++++1++++1++++++1+++++++++++r+1++++2+++++++++++++++3++++++++rrrrrrrrrrrrr++
+++++++++++++T+++++++++++++++++++r+++3+++3++r++++++++++++++++++r+++++++++&r+++r+++++++++++++++++++++++1++++++r+++++++++++++rrrrrrrrrrrrrrrrr+++++++++++++r++
+++++++++++++++++++++++++++++++++r++++++++++r++++++++++++++++++rIIIIIIIIIIr++++r+++++++++++++++++++++++++++++r+++++++++++++r++++++++++++++++r++++++++++++r++
+++++++++++++++++++++++++++++++++r^^^^^^^^^^r++++++++++++++++++r&IIIIIIIIIr+++++rrrrrrrrrrrrrrrrrrrrrr+++++++r+++2+++++++++r++++++++++++++++r+5++++++++++r++
+++++++++++++++++++++++++++++++++r^^^OOOOO^^r++++++++++++++++++r&IIIIIIIIIr+++++++++++++++++++++++++++r++++++r+++++++++2+++r++++++++++++++++r++++++++++++r++
+++++++++++++++++++++++++++++++++r++++++++++r++++++++++++++++++r++++++++++r++++++++++++++++++++++++++++r+++++r+++++++++++++r++++++++++++++++r+++++++EEEE+r++
+++++++++++++++++++++++++++++++++r++++++++++r++++++++++++++++++r++++++++++r++++++++++++++++++++++++++++r+++3++++++3++++++++r++++++++++++++++r+++++EEEMEEEr++
+++++++++++++++++++++++++++++++++r++++++++++r++++++++++++++++++r++++4+++++r++++++++++++++++++++++++++++r+++++3++++3++++++++r++++++++++++++++rrrrrrrrrrrrr++
+++++++++++++++++++++++++++++++++r++++++++++r++++++++++++++++++r++4+++++++r++++++++++++++++++++++++++++rrrrrrrrrrrrrrrrrrrrr++++++++++++++++++++++++++++++++
+++++++++++++++++++++++++++++++++r++1+++++++r++++++++++++++++++r++++++++++r+++++++++++++++++++++++++++++++++++++++++++++++++++++++++++++++++++++++++++++++++
++++++++++++++++++++++++++++++++rr+++1+1+++1rr++++++++++++++++rr++++++++++rr++++++++++++++++++++++++++++++++++++++++++++++++++++++++++++++++++++++++++++++++
+++++++++++++T+++++++++++++++++rr++++++++++++rr+++rTTrrTTr+++rr++++++++++++rr+++++++++++++++++++++++++++++++++++++++++++++++++++++++++++++++++++++++++++++++
++++++++++++++++++++++++++++++rrIIIIIIIIIIIIIIrr+r+++rr+++r+rr+++2++++++++++rr++++++++++++++++++++++++++++++++++++++++++++++++++++++++++++++++++++++++++++++
+++++++++++++++++++++++++++++rrIIIIIIIIIIIIIIIIrr++++++++++rr++++++++3+++++++rr+++++++++++++++++++++++++++++++++++++++++++++++++++++++++++++++++++++++++++++
+++++++++++++++++++++++++++++rIIIIIIIIIIIIIIIIIII+rrrrrrrr+++++++++++++++3++++r+++++++++++++++++++++++++++++++++++++++++++++++++++++++++++++++++++++++++++++
++++++++++++++++++++++++++++rIIIIIIIIIIIIIIIIIIOIrr+++++++rr+++++2++++++++++++r+++++++++++++++++++++++++++++++++++++++++++++++++++++++++++++++++++++++++++++
++++++++++++++++++++++++++++r++^^^^^^^^OOOOOOOOOr+++++++++++r+++++++++++++++++r+++++++++++++++++++++++++++++++++++++++++++++++++++++++++++++++++++++++++++++
++++++++++++++++++++++++++++rr+++++++++++++++++rr+++++++++++rr+++++++++++++++rr+++++++++++++++++++++++++++++++++++++++++++++++++++++++++++++++++++++++++++++
+++++++++++++++++++++++++++++rr++++3+++++3++++rr+++++++++++++rr+++++++++++++rr++++++++++++++++++++++++++++++++++++++++++++++++++++++++++++++++++++++++++++++
++++++++++++++++++++++++++++++rr+++++++++++++rr+++++++++++++++rr+++++++++++rr+++++++++++++++++++++++++++++++++++++++++++++++++++++++++++++++++++++++++++++++
+++++++++++++++++++++++++++++++rr+++++++++++rr+++++++++++++++++rr+++++++++rr++++++++++++++++++++++++++++++++++++++++++++++++++++++++++++++++++++++++++++++++
+++++++++++++T+++++++++++++++++++rrrrrrrrrrr+++++++++++++++++++++rrrrrrrrr++++++++++++++++++++++++++++++++++++++++++++++++++++++++++++++++++++++++++++++++++
++++++++++++++++++++++++++++++++++++++++++++++++++++++++++++++++++++++++++++++++++++++++++++++++++++++++++++++++++++++++++++++++++++++++++++++++++++++++++++
++++++++++++++++++++++++++++++++++++++++++++++++++++++++++++++++++++++++++++++++++++++++++++++++++++++++++++++++++++++++++++++++++++++++++++++++++++++++++++
++++++++++++++++++++++++++++++++++++++++++++++++++++++++++++++++++++++++++++++++++++++++++++++++++++++++++++++++++++++++++++++++++++++++++++++++++++++++++++
++++++++++++++++++++++++++++++++++++++++++++++++++++++++++++++++++++++++++++++++++++++++++++++++++++++++++++++++++++++++++++++++++++++++++++++++++++++++++++