+++++++++++++T++++++++++++++++++++++++++++++++++++++++++++++++++++++++++++++++++++++++++++++++++++++++++++++++++++++++++++++++++++++++++++++++++++++++++++++++++++++++++++++++++++++++++++++++++++++++++++++++++++++++++++++++++++++++
++++++++T++++++++T++++++++++++++++++++++++++++++++++++++++++++++++++++++++++++++++++++++++++++++++++++++++++++++++++++++++++++++++++++++++++++++++++++++++++++++++++++++++++++++++++++++++++++++++++++++++++++++++++++++++++++++++++++
++++++++++++++++++++++T+++++++++++++++++++++++++++++++++++++++++++++++++++++++++++++++++++++++++++++++++++++++++++++++++++++++++++++++++++++++++++++++++++++++++++++++++++++++++++++++++++++++++++++++++++++++++++++++++++++++++++++++
+++++++++T++++++++++++++++++++++++++++++++++++++++++++++++++++++++++++++++++++++++++++++++++++++++++++++++++++++++++++++++++++++++++++++++++++++++++++++++++++++++++++++++++++++++++++++++++++++++++++++++++++++++++++++++++++++++++++
+++++++++++T++T+++++++++++++++++++++++++++++++++++++++++++++++++++++++++++++++++++++++++++++++++++++++++++++++++++++++++++++++++++++++++++++++++++++++++++++++++++++++++++++++++++++++++++++++++++++++++++++++++++++++++++++++++++++++
++++++++++++rrrrrrrrrrrrrrrrrrrr++++++++++++++++++++++++++++++rrrrrrrrrrrrrrrrrrrrrrrrrrr+++++++++++++++++++++++++++++++++++++++rrrrrrrrrrrrrrrrrrrrrrrrrrrrrr++++++++++++++++++++++++++++++++++++++++rrrrrrrrrrrrrrrrrrrrrrrrrrr+++++
+++++++++++r++++++++++++++++++++r++++++++++++++++++++++++++++r++++++++^+++++OO+++++++++++r++++++++++++++++++++++++++++++++++++rr++++++++++++++3+++++++++++++++r++++++++++++++++++++++++++++++++++++++r++5++++++++++++++EEEE++++++r++++
+++++++++++r++++M+S+++++++++++++r++++++++++++++++++++++++++++r+++++++++^+++OO++++++++++++r+++++++++++++++++++++++++++++++++++r++++++++++4+++++++++4++++++++++++r++++++++++++++++++++++++++++++++++++r++++++++++++++++EEEEMEEE+++r+++++
+++++++++++r++++++++++++++++++++r+++++++++++++++++++++++++++r+++++++++++^+++OO++++1++1+1++r++++++++++++++++++++++++++++++++++r++++++++++++++++++++++++++++++++++r++++++++++++++++++++++++++++++++++r++5+++++++++++++++EEEEEEEE+r++++++
+++++++++++r+++++++++++++++++++++r+++++++++++++++++++++++++r+++++++++++^+^++OO+++++++++++++r++++++++++++++++++++++++++++++++r++++++++++++++++++++++++++++++++++++r++++++++++++++++++++++++++++++++r+++++++++++++++++++++++++++r+++++++
+++++++++++r+T++++R++++T++1+1++1++r+++++++++++++++++++++++r+++++++++++++^^++OO++++++++++++++r++++++++++++++++++++++++++++++r+++++++++++1++1++1++1++1+1++++++++++++r++++++++++++++++++++++++++++++r+++++++++++++++++++++++++++r++++++++
++++++++++r++++3++++++3+++1+++++++r++++++++++++++++++++++r++++++++++++++^+^+OO+++++++11++++++r++++++++++++++++++++++++++++r++++++++++++++++++++++++++++++++++++++++r++++++++++++++++++++++++++++r+++++++3+++++3+++++++++++++r+++++++++
++++++++++r+++3+++++++++++++++++++r+++++++++++++++++++++r++++++++++++++^+^^+OO++++++++++++++++r++++++++++++++++++++++++++r++++++++++++++++++++++++++++++++++++++++++r++++++++++++++++++++++++++r+++++++++++++++++++++3+++++r++++++++++
+++++++++r+++++++++++++++++++++++++r+++++++++++++++++++r+++++++++++++rrrrrrrrrrrrrrr+++++++++++r++++++++++++++++++++++++r++++++++++++rrrrrrrrrrrrrrrrrrr+++++++++++++r++++++++++++++++++++++++r+++++++++++++++++++++++++++r+++++++++++
++++++++r++++3++++3+++++3+++++3+++++r+++++++++++++++++r++++++++++++&r+++++++++++++++r+&+++++++++r++++++++++++++++++++++rOOOOOOOOOOOOr+++++++++++++++++++rIIIIIIIIIIIIIr++++++++++++++++++++++r+++++++++++++++++++++++++++r++++++++++++
++++++++r+++++++++++++++++++++++++++r++++++++++++++++r++++++++++++&r+++++++++++++++++r+++++++++++r++++++++++++++++++++r++++++++++++r+++++++++++++++++++++rIIIIIIIIIIIIIr++++++++++++++++++++r^^^^^^^^^^^^^^^^^^^^^^^^^^^r+++++++++++++
++++++++r+++++++++++++++++++++++++++r+++++++++++++++r++++++++++++&r+++++++++++++++++++r+&+++++++++r++++++++++++++++++r+&++++++++++r+++++++++++++++++++++++rIIIIIIIIIIIIIr++++++++++++++++++rIIIIIIIIIIIIIIIIIIIIIIIIIIIr++++++++++++++
++++++++r++++++++++++++++++++++++++1+r+++++++++++++r+++++++++++++r+++++++++++++++++++++r+++++++++++r++++++++++++++++r+++++++++++&r+++++++++++++++++++++++++r^^OOOOOOOOOOOr++++++++++++++++r++^^^++++++++++++++++++^^^+r+++++++++++++++
++++++++r++++++++++++++++++++++++++++r++++++++++++r+&+++++++++++r+++++++++++++++++++++++r&++++++++++r++++++++++++++r^^^^^^^^^^^^r+++++++++++++++++++++++++++rIIIIIIIIIIIIIr++++++++++++++r+O++++++OOOO+++OO++OO++++++r++++++++++++++++
+++++++r+++3+++++2+++++++2+++2++++++++r++++++++++r+&+++++++++++r+++++++++++++++++++++++++r+++++++++&+r++++++++++++r+&++++++++++r+++++++++++++++++++++++++++++rIIIIIIIIIIIIIr++++++++++++r^^+^^^^^^++++^^^++^^++^^^^^r+++++++++++++++++
++++++r++++++++++++++++++++++++++++++++r++++++++r+++++++++++++r+++++++++++++++++++++++++++r+++++++++++r++++++++++r^^^^^^^^^^^^r+++++++++++++++++++++++++++++++rIIIIIIIIIIIIIr++++++++++r+++++++++++++^^^^^^^^++++++r++++++++++++++++++
++++++r++++++++++++++++++++++++++++++++r+++++++r++++++++++++&r+++++++++++++++++++++++++++++r+++++++++++r++++++++r+++++++++++&r+++++++++++++++++++++++++++++++++rOOOOOOOOOOOOOr++++++++r+++++++++++++++++++++++++++r+++++++++++++++++++
+++++++rr++++1++++++++1+++++++++1++++1++r+++++r++++++++++++&r+++++++++++++++++++++++++++++++r++1+1++++++r++++++r^^^^^^^^^^^^r+++++++++++++++++++++++++++++++++++r+++++++++++++r++++++rOOOOO^^^^^^^^^^^^^^^^OOOOOOr++++++++++++++++++++
+++++++++r+++++++++++++++++++++++++++++^rrrrrr+++++++++++++r+++++++++++++++++++++++++++++++++r+++++++++++rrrrrr++++++++++++r+++++++++++++++++++++++++++++++++++++r+++++++++++++rrrrrr+++++++++++++++++++++++++++r+++++++++++++++++++++
++++++++++r++++++++++++++++++++++++++++^+O++++++++++++++++r+++++++++++++++++++++++++++++++++++r+++++++++++++O+++++++++++++r+++++++++++++++++++++++++++++++++++++++r++++++++++++++++++++++++++++++++++++++++++++r++++++++++++++++++++++
+++++++++++r+++++++++++++++++++++++++++^+O+++++++++++++++r+++++++++++++++++++++++++++++++++++++r+++++++2++++O++++2+++++++r+++++++++++++++++++++++++++++++++++++++++r++++++++++++4++++4++++++++++++++++++++++++r+++++++++++++++++++++++
++++++++++++rr+++++++++++++++++++++++++^+O++++++++++++++r+++++++++++++++++++++++++++++++++++++++r+++++++++++O+++++++++++r++++++++++++++++++++++++++++++++++++++++++r++++++++++++++++++++++++++++++++++++++++rr++++++++++++++++++++++++
+++++++++++++rrrrrrrrrrrrrrrrrrrrrrrrrrrrrrrrrrrrrrrrrrr+++++++++++++++++++++++++++++++++++++++++rrrrrrrrrrrrrrrrrrrrrrr++++++++++++++++++++++++++++++++++++++++++++rrrrrrrrrrrrrrrrrrrrrrrrrrrrrrrrrrrrrrrr++++++++++++++++++++++++++
++++++++++++++++++++++++++++++++++++++++++++++++++++++++++++++++++++++++++++++++++++++++++++++++++++++++++++++++++++++++++++++++++++++++++++++++++++++++++++++++++++++++++++++++++++++++++++++++++++++++++++++++++++++++++++++++++++++
++++++++++++++++++++++++++++++++++++++++++++++++++++++++++++++++++++++++++++++++++++++++++++++++++++++++++++++++++++++++++++++++++++++++++++++++++++++++++++++++++++++++++++++++++++++++++++++++++++++++++++++++++++++++++++++++++++++
++++++++++++++++++++++++++++++++++++++++++++++++++++++++++++++++++++++++++++++++++++++++++++++++++++++++++++++++++++++++++++++++++++++++++++++++++++++++++++++++++++++++++++++++++++++++++++++++++++++++++++++++++++++++++++++++++++++

