+++++++++++++T+++++++++++++++++++++++++++++++
++++++++T++++++++T+++++++++++++++++++++++++++
++++T+++++++++++++++++T++++++++++++++++++++++
+++++++++T+++rrrrrrr+++++++++++++++++++++++++
+++++++++++T++++++++T++++++++++++++++++++++++
++++++++++++++++++++rr+++++++++++++++++++++++
+++++++++++++++++++r++rr+++++++++++++++++++++
++++++++++++++++++++r+++r++++++++++++++++++++
+++++++++++++++++++++rM++r+++++++++++++++++++
+++++++++++++++++++++r+S+r+++++++++++++++++++
++++++++++++++++++++r+++++r++++++++++++++++++
+++++++++++++++++++r++++++r++++++++++++++++++
+++++++++++++++++rrr++++++rrr++++++++++++++++
+++++++++++++++rr+++rIIIIIr++r+++++++++++++++
++++++++++++++r++++++rrrOOOO++r++++++++++++++
++++++++++++++rIIIIIIIIIIIIIIIr++++++++++++++
+++++++++++++rrIIIIIIIIIIIIIIIrr+++++++++++++
++++++++++rrr+rIIIIII2IIIIIIrr++r++++++++++++
+++++++++r+++++rIIIIIIIIIIIr+++++r+++++++++++
+++++++++r++++rII11IIIIIIrr++++++r+++++++++++
+++++++++r+++++++++rrrrrr+5++++++r+++++++++++
+++++++++r++++3+++++3++++++++++++r+++++++++++
++++++++++r+++3++++3++++++++++++r++++++++++++
+++++++++++rrr+++++++++++++++rrr+++++++++++++
++++++++++++++rrrrrOOOOOrrrrr++++++++++++++++
+++++++++++++++++++r^^^r+++++++++++++++++++++
++++++++++++++++++++rIIIr++++++++++++++++++++
+++++++++++++++++++++rIIIr+++++++++++++++++++
+++++++++++++++++++++r^^^^r++++++++++++++++++
++++++++++++++++++++r^OOO^r++++++++++++++++++
+++++++++++++++++++r++3+++r++++++++++++++++++
+++++++++++++++++rrr++++++rrr++++++++++++++++
+++++++++++++++rr+5+r+11+r+++r+++++++++++++++
++++++++++++++r++++++r++r+++++r++++++++++++++
++++++++++++++r+++++++++++++++r++++++++++++++
+++++++++++++rr++++4+++++11+++rr+++++++++++++
++++++++++rrr+r+++++++++++++rr++r++++++++++++
+++++++++r+++++r+++++3+++++r++&++r+++++++++++
+++++++++r++++++rr+++++++++++++++r+++++++++++
+++++++++r+++++&++rrrrrrr++++++++r+++++++++++
+++++++++r+++++++++++++++++2+++++r+++++++++++
++++++++++r+++++++++++++++++++rrr++++++++++++
+++++++++r++++++++++++2+++++++r++++++++++++++
++++++++rr++++rrrrr++++++rrrrr+++++++++++++++
+++++++r^^^^^^^+++rrrrrrr++++++++++++++++++++
+++++++r^^^^+^^^+r+++++++++++++++++++++++++++
+++++++r++++++++++r++++++++++++++++++++++++++
++++++rOOO+^^O^^^^Or+++++++++++++++++++++++++
+++++r++++^^^OOO^^OOr++++++++++++++++++++++++
++++++rr+++++^^^++rr+++++++++++++++++++++++++
++++++++rrrr+++rrr+++++++++++++++++++++++++++
++++++++++++r++r+++++++++++++++++++++++++++++
+++++++++++r++++r++++++++++++++++++++++++++++
++++++++++r+++4++rrrrrrrrrrrrrrrr++++++++++++
++++++++++r+++++++++++3++++++++++r+++++++++++
++++++++++r++++++++++++++++++++++r+++++++++++
++++++++++r+++++++1+1+++++1++1+++r+++++++++++
++++++++++r++++++++1+++1+++++++++r+++++++++++
++++++++++r++++++++++++++++1++++r++++++++++++
++++++++++r++++++3++++++++++++++r++++++++++++
++++++++++rrrrrrrrrrrrrrrrr+++++r++++++++++++
+++++++++++++++++++++++++r++++++r++++++++++++
+++++++++++++++++++++++++r+++EEEr++++++++++++
+++++++++++++++++++++++++r++EEMEr++++++++++++
+++++++++++++++++++++++++rrrrrrrr++++++++++++
+++++++++++++++++++++++++++++++++++++++++++++
+++++++++++++++++++++++++++++++++++++++++++++
+++++++++++++++++++++++++++++++++++++++++++++
+++++++++++++++++++++++++++++++++++++++++++++