++++++++++++++r++++++++++++++++++++++++++++++++++++++
++++++++++++++r++++++++++++++++++++++++++++++++++++++
+T++++++r+++T+++++++++++++++++++++++++++++++T++++++++
++++++rrrrrrrrrrrrrrrrrrrrrrrrrrrrrrrrrrrrrrr++++++++
++++++r+++++++++++++++++++++++++++++++++++++r++++++++
++++++r+++++++++++++++++++++++++++++++++++++r++R+++++
++++++r+++M+S+++++++++1+++++1+++++++++++++++r++++++++
++++++r+++++++++++++++++++++++++++++++++++++r++++++++
++++++r+++++++++++++++++R+++++++++++++++++++r++++++++
++++++rrrrrrrrrrrrrrrrrr++rrrrrrr^^^^^^^^^^^r++++++++
++++++++++++++++++++++++++++++++r+++++++++++r++++++++
++++++++++++++++++++++++++++++++r+++++++++++r++++++++
++++++++++++++++++++++++++++T+++r++R++++++++r++++++++
++++++++++++++++++++++++++++++++r+++++++++++r++++++++
++++++++++++++++++++++++++++++++r++&++++++++r++++++++
++++++rrrrrrrrrrrrrrrrrrrrrrrrrrr+++++++++++r++++++++
++++++r+++++++++++++++++++++++++O+++++++++++r++++++++
++++++r+++++++++++++++++++++++++O+++++++++++r++++++++
++++++r+++++++++++++++++++++++++O+++++++++++r++++++++
++++++r+++++++++++++++++++++++++O+++++++++++r++++++++
++++++r+++++++++rrrrrrrrrrrrrrrrrrrrr++++rrrr++++++++
++++++r+++++++1+r+++++++++++++++r+++++++++++r++++++++
++++++r+++++1++++r+++++++++++++++r+&+++++++r+++++++++
++++++r+++++++++r++++++++++++++r++++++++++++r++++++++
++++++r+++++++++r++++++++++++++rR+++1++1++1++r+++++++
+++++++R+OOOOOT+r++++++++++++++r+++++++++++++r+++++++
+++++++r+++++++r+++++++++++++++r++&++++++++&+r+++++++
+++++++r++++++++rrrrrrrrrrrrrrrr+++++++++++++r+++++++
+++++++r+++++++++r+++++++++++++++++++++++++++r+++++++
+++++++r+++++++++r+++++++++++++++++++++++++++r+++++++
+++++++r+++++++++r+++++EE++++++++++++++++++++r+++++++
+++++++r+++++++++r++EEEMEEE++++++++++++++++++r+++++++
++++++++rOOOOOOOOOr++++EE++++++++++++++++++++r+++++++
++++++++r+++++++++rrrrrrrrOOOOOOOOOOOOOOOOOOOr+++++++
++++++++r+++++++++O+++++^++++++++++++++++++++r+++++++
++++++++r+++++++++O+++++^++++++++++++++++++++r+++++++
++++++++r+++++++++O+++++^++++++++++++++++++++r+++++++
++++++++r+++++++++O+++++^++++++++++++++++++++r+++++++
++++++++rrrrrrrrrrrrrrrrrrrrrrrrrrrrrrrrrrrrrr+++++++
++++++++++++++r++++++++++++++++++++++++++++++++++++++
++++++++++++++r++++++++++++++++++++++++++++++++++++++
++++++++++++++r++++++++++++++++++++++++++++++++++++++
