+++++++++++++++++++T+++++++++++++++++++++++++
++++++++++++++T++++++++T+++++++++++++++++++++
++++++++++T+++++++++++++++++T++++++++++++++++
+++++++++++++rrrrr+++++++++++++++++++++++++++
++++++++++++r+++++r++++++++++++++++++++++++++
+++++++++++r++++M++r+++++++++++rrrr++++++++++
+++++++++++r++S++++rrrrrrrrrr+r++++r+++++++++
+++++++++++r+++++++++++++++++rr+++++r++++++++
+++++++++++r++++++++++++++++++++2+++r++++++++
+++++++++++r++++++++++++++++++++++++r++++++++
++++++++++++r+++++++2+++++++++++++++r++++++++
++++++++++++r++++++++++++++++2+++++r+++++++++
++++++++++++r+++2++++++++++++++++++r+++++++++
+++++++++++r+r++++++++++++++++++++r++++++++++
+++++++++++r++rr+++TT+++++++++TT+rr++++++++++
+++++++++++r++++rrrR+rrrr++++rR+r++r+++++++++
++++++++++r++++++++++++++r++++r++++r+++++++++
+++++++++r+++2++++++++++++++++r++++r+++++++++
+++++++++r++++++++++r++++R++++r++++r+++++++++
++++++++r++++++++++r++2+++++2++r+++r+++++++++
++++++++r++++++++++r+++++++++++r++++r++++++++
+++++++r+++++2++++r+r+rrrrrrr+r+++r+r++++++++
+++++++r++r++++++r+++r+r++++rr++r+r++r+++++++
+++++++rrrr+++++r++++r+r++++r+++rr+rrr+++++++
+++++++++rr++++r+++++r++rr++r++++++r+++++++++
++++++++++r+++rr++++++r++++r++++++++rr+++++++
+++++++++r++++r++++++++rrrr+++++2++++r+++++++
++++++++r+++++r+++2++++r+++++++++++++r+++++++
+++++++r+++++r+++++++++r++++++++r+++++r++++++
+++++++r++++r++++++++++r++++++++rr++++r++++++
++++++r+++++r+++++++++++++2++++r++r+++r++++++
++++++r++++r+++rrrr++++++++++++r+r++++r++++++
++++++r+++rrrrr++++++++++++++++r+r+++r+++++++
++++++r++++++++++++++2++rrrrrrrr+r+2+r+++++++
++++++r+++++++++++++++++++++++r++r+++r+++++++
+++++++r+++2++++++r+++++++++++r+++rrr++++++++
++++++++r+++++++rr+++++r+++++++r+++++++++++++
+++++++++r++++rr+++++++r+++++++r+++++++++++++
+++++++++rrrrr+++++2+++r++++++++r++++++++++++
+++++++++r+++++++++++++r++++2+++r++++++++++++
++++++++r++++++++++++++r++++++++r++++++++++++
++++++++r+++++++r++++++r++++++++r++++++++++++
++++++++r++2+++r+rrrrrr+r+++++++r++++++++++++
++++++++r++++++r+++++++++r+++++r+++++++++++++
++++++++r+++++r+++++++++++r+++r++++++++++++++
+++++++r++++rr++++++++++++r+++r++++++++++++++
+++++++r++++r++++++++++++r+++++r+++++++++++++
+++++++r++++r++++++++++++r++++++r++++++++++++
+++++++r+++r+++++++++++++r+++2+++r+++++++++++
+++++++r+++r++++++++++++++r+++++++r++++++++++
++++++++rrr++++++++++++++++r++++++r++++++++++
++++++++++++++++++++++++++++r+++++r++++++++++
+++++++++++++++++++++++++++++r+++++r+++++++++
+++++++++++++rrrrr++++++++++++r++++r+++++++++
++++++++++++r+++++r++++++++++++r+++r+++++++++
+++++++++++r+++++++r+++++++++++r+++r+++++++++
+++++++++++r+++++++rrrrrrrrrr+r++++r+++++++++
+++++++++++r+++r+++++++++++++rr+++++r++++++++
+++++++++++r++++rr++++++++++++++++++r++++++++
+++++++++++r++++++r+++++++++++++++++r++++++++
++++++++++++r++++++r+++++2++++++2+++r++++++++
++++++++++++r++++++r+++++++++++++++r+++++++++
++++++++++++r++2+++r+++++++++++++++r+++++++++
+++++++++++r++++++++++++++++++++++r++++++++++
+++++++++++r+++++++TT+++++++++TTrrr++++++++++
+++++++++++r+++++++R+rrrrrrrrrR++++r+++++++++
++++++++++r++++++++++++++rr+++++2++r+++++++++
+++++++++r+++++++++++++++r+++++++++r+++++++++
+++++++++r++++2+++++r++++R++++r++++r+++++++++
++++++++r++++++++++r+++++++++++r+++r+++++++++
++++++++r++++++++++r+++++++++++r++++r++++++++
+++++++r++++++++++r+r+rrrrrrr+r+++++r++++++++
+++++++r++r++++++r+++r+r++++rr+++++++r+++++++
+++++++rrrr+++++r++++r+r++++r++++++rrr+++++++
+++++++++rr++r+r+++++r++rr++r+++2++r+++++++++
++++++++++r+r+rr++2+++r++++r+r++++++rr+++++++
+++++++++r+rr++++++++++rrrr+++r++++++r+++++++
++++++++r++++++++++++++++++++++r+++++r+++++++
+++++++r+++2+++++++++++2++++++++r++2++r++++++
+++++++r+++++++++2++++++++++++++r+++++r++++++
++++++r++++++++++++++++++++2+++r++++++r++++++
++++++r++++r+++rrrr++++++++++++rrr++++r++++++
++++++r+++rrrrr++++rrrr++++++++++++++r+++++++
++++++r++++++++++++r+++rrrr++++++++2+r+++++++
++++++r++++++++++++++++++++rrrrrrr+++r+++++++
+++++++r+++2++++++++++++++++++r+++rrr++++++++
++++++++r+++++++++++r++++++++++r+++++++++++++
+++++++++r++++++++++r+++2++++++r+++++++++++++
+++++++++rrrrr+++rrrr+++++++++++r++++++++++++
+++++++++r+++++++++++r++++++++++r++++++++++++
++++++++r+++++++++++++r+++++++++r++++++++++++
++++++++r+++2+++r++++++r+++2++++r++++++++++++
++++++++r++++++r+rrrrrr+r+++++++r++++++++++++
++++++++r++++++r+++++++++r+++++r+++++++++++++
++++++++r+++++r+++++++++++r+++r++++++++++++++
+++++++r++++rr++++++++++++r+++r++++++++++++++
+++++++r++++r++++++++++++r+++++r+++++++++++++
+++++++r+2++r++++++++++++r++++++r++++++++++++
+++++++r+++r+++++++++++++r+++++++r+++++++++++
+++++++r+++r++++++++++++++rEEEEEEEr++++++++++
++++++++rrr++++++++++++++++r++++++r++++++++++
++++++++++++++++++++++++++++r++M+r+++++++++++
+++++++++++++++++++++++++++++rrrr++++++++++++
+++++++++++++++++++T+++++++++++++++++++++++++
++++++++++++++T++++++++T+++++++++++++++++++++
++++++++++T+++++++++++++++++T++++++++++++++++