+++++++++++++++++++++++++++++++++++++++++++++++++++++++++++++++++++++++++++++++++++++++
+++++++++++++++++++++T+++++++++r+++++++++++++++++++++++++++++++++++R+++++++++++++++++++
++++++++++++++++++++++++++++++++++++T++++++++++++++++++++++++++++++++++++T+++++++++++++
++++++rrrrrrRrrrrrrrrrrrrrrrrrrrrrrrrrrrrrrrrrrrRrrrrrrrrrrrRrrrrrrrrrrrrrrrrrrrr++++++
++++++r+++++++++++^^^^^^^^^^++++++++++++^^^^^^^^^^^^^^++++++++++++++++++++++++++r++++++
++++++r+M+S++++++++++++++++^++++++++++++^++++++++++++^+++++4++++++++++++++++++++r++++++
+++T++r++++++++++++++++++++^^^^^^^^^^^^^^++++++++++++^++++++++++++++++++++++++++r++++r+
++++++rrrrrrrrrrrrrrrrrrrrrrrrrrrrrrrrrrrrrrrrrrrrrrrrrrrrrrrrrrrrrrrrrrrrr++1++r++++++
++++++r+^+++++++++++++++++++++++++++++++++++++++++++++++++^^++^^++^^+++^O+++++++r++++++
++++++r++^++++++++++++++++++++++++++++++++++++++++++++++++^^++^^++^^+++^O+++++++r++++++
++++++r+++^++++++++++++++++4+++++++++1++++++++1++++++^^^^^^^++^^++^^+++^O+++++++r++++++
++R+++r++++^++++++++++++++++++++++++++++++++++++++++++++++^^++^^++^^+++^O+++++++r++++++
++++++r+++++^+++++++++++++++++++++++++++++++++++++++++++++^^++^^++^^+++^O+++++++r++++++
++++++r++1++rrrrrrrrrrrrrrrrrrrrrrrrrrrrrrrrrrrrrrrrrrrrrrrrrrrrrrrrrrrrrrrrrrrrr++T+++
++++++r+++++^+++++++++++++++++++++++++++++++++++++++++++++++++++++++++++++++++++r++++++
++++++r++++^++++++++++++++++++++++++++++++++++++++++++++++++++++++++++++++++++++r++++++
++++++++++^++++1+1+1+++1+1+1+++1+1+1+++1+1+1+++1+1+1+++++++4++++++++++++++++++++r++++++
+++++R+++^++++++++++++++++++++++++++++++++++++++++++++++++++++++++++++++++++++++r++++++
++++++r+^+++++++++++++++++++++++++++++++++++++++++++++++++++++++++++++++++++++++r++++++
++++++rrrrrrrrrrrrrrrrrrrrrrrrrrrrrrrrrrrrrrrrrrrrrrrrrrrrrrrrrrrrrrrrrrrrr++1++r++++++
++++++r+++++++++++++++++++++++++++++++++++++++++++++++++++++++++++++++++++++++++r++++++
++++++r+++++++++++++++++++++++++++++++++++++++++++++++++++++++++++++++++++++++++r++++T+
+++T++r++++++++++++++++++++4+++++++++2+++++++2+++++++2++++++++++++++++++++++++++r++++++
++++++r++++++++++++++++++++++++++++++++++++++++++++++++++++++++++++++++++++++++++++++++
++++++r+++++++++++++++++++++++++++++++++++++++++++++++++++++++++++++++++++++++++r++++++
+++r++r++1++rrrrrrrrrrrrrrrrrrrrrrrrrrrrrrrrrrrrrrrrrrrrrrrrrrrrrrrrrrrrrrrrrrrrR+rrrrr
++++++r+++++++^+++++++^+++++++^+++++++^+++++++^+++++++^++++++++++^++^++^++^+E++++++++++
++++++r+++++++^++++++++++++++++++++++++++++++++++++++++++++4+++++^++^++^++^+E+M++++++++
++++++r+++++++^+++^+++++++^+++++++^+++++++^+++++++^++++++++++++++^++^++^++^+E++++++++++
++++++rrrrrrrrrrrrrrrr++rrrrrrrrrrrrrrrrrrrrrrrrrrrrrrrrrrrrrrrrrrrrrrrrrrrrrrrrrrrrrrr
+++T+++++++r++++++++++R++++++++++++++++++++++++++++++++++++++++++++++++++++++++++++++++
+++++++++++++++T+++++++++++++++++T++++++++T+++++++++++++T+++++++++++r+++++++++++T+T++++
+++++++++++++++++++++++++++++++++++++++++T+++++++++++++++++++++++++++++++++++++++++++++