++++++++++++++++++++++++++++++++++++++++++++++++++
++++++++++++++++++++++++++++++++++++++++++++++++++
++++++++++++++++++++++++++++++++++++++++++++++++++
++++++rrrrrrrrrrrrrrrrrrrrrrrrrrrrrrrrrrrrrr++++++
++++++r++++M+++++++++++++++++++++++++++++++r++++++
++++++r++S+++++++++++++++++++++++++++++++++r++++++
++++++r++++++++++++++++++++++++++++++++++++r++++++
++++++r++++++++++++++++++++++++++++++++++++r++++++
++++++r&+++++++++++++++++++++++++++++++++++r++++++
++++++r+++++++++++++++++++++++++++++++++++&r++++++
++++++r+++++++++1++++++++++++++++1+++++++++r++++++
++++++r++++++++++++++++++++++++++++++++++++r++++++
++++++r&+++++++++++++++++++++++++++++++++++r++++++
++++++r+++++++++++++++++++++++++++++++++++&r++++++
++++++r++++++++++++++++++++++++++++++++++++r++++++
++++++r++++++++++++++++++++++++++++++++++++r++++++
++++++r&++++++++2++++++++++++++++2+++++++++r++++++
++++++r+++++++++++++++++++++++++++++++++++&r++++++
++++++r++++++++++++++++++++++++++++++++++++r++++++
++++++r++++++++++++++++++++++++++++++++++++r++++++
++++++r&+++++++++++++++++++++++++++++++++++r++++++
++++++r+++++++++++++++++++++++++++++++++++&r++++++
++++++r+++++++++1++++++++++++++++1+++++++++r++++++
++++++r++++++++++++++++++++++++++++++++++++r++++++
++++++r&+++++++++++++++++++++++++++++++++++r++++++
++++++r+++++++++++++++++++++++++++++++++++&r++++++
++++++r++++++++++++++++++++++++++++++++++++r++++++
++++++r++++++++++++++++++++++++++++++++++++r++++++
++++++r&++++++++2++++++++++++++++2+++++++++r++++++
++++++r+++++++++++++++++++++++++++++++++++&r++++++
++++++r++++++++++++++++++++++++++++++++++++r++++++
++++++r++++++++++++++++++++++++++++++++++++r++++++
++++++r&+++++++++++++++++++++++++++++++++++r++++++
++++++r+++++++++++++++++++++++++++++++++++&r++++++
++++++r+++++++++1++++++++++++++++1+++++++++r++++++
++++++r++++++++++++++++++++++++++++++++++++r++++++
++++++r&+++++++++++++++++++++++++++++++++++r++++++
++++++r+++++++++++++++++++++++++++++++++++&r++++++
++++++r++++++++++++++++++++++++++++++++++++r++++++
++++++r++++++++++++++++++++++++++++++++++++r++++++
++++++r&++++++++2++++++++++++++++2+++++++++r++++++
++++++r+++++++++++++++++++++++++++++++++++&r++++++
++++++r++++++++++++++++++++++++++++++++++++r++++++
++++++r++++++++++++++++++++++++++++++++++++r++++++
++++++r&+++++++++++++++++++++++++++++++++++r++++++
++++++r+++++++++++++++++++++++++++++++++++&r++++++
++++++r+++++++++1++++++++++++++++1+++++++++r++++++
++++++r++++++++++++++++++++++++++++++++++++r++++++
++++++r++++++++++++++++++++++++++++++++++++r++++++
++++++r+++++++++++++++++++++++++++++++++EEEr++++++
++++++r+++++++++++++++++++++++++++++++++E++r++++++
++++++r+++++++++++++++++++++++++++++++++E+Mr++++++
++++++rrrrrrrrrrrrrrrrrrrrrrrrrrrrrrrrrrrrrr++++++
++++++++++++++++++++++++++++++++++++++++++++++++++
++++++++++++++++++++++++++++++++++++++++++++++++++
++++++++++++++++++++++++++++++++++++++++++++++++++