++++++++++++++r++++++++++++++++++++++++++++++++++++++++++++++++++++r+++++++++++++++++++++++++++++++++++++++++++++++++++++++++++++++++++++++++++++++++++++++++++++++++++++++++++++++++++++++++++++++++++++++++++++++++++
+++++++++++++++++++++++++++++++++++++++++++++++++++++++++++++++++++r+++++++++++++++++++++++++++++++++++++++++++++++++++++++++++++++++++++++++++++++++++++++++++++++++++++++++++++++++++++++++++++++++++++++++++++++++++
++++++++++++++r++++++++++++++++++++++++++++++++++++++++++++++++++++r+++++++++++++++++++++++++++++++++++++++++++++++++++++++++++++++++++++++++++++++++++++++++++++++++++++++++++++++++++++++++++++++++++++++++++++++++++
+T++++++r+++T+++++++++++++++++++++++++++++++T++++++++++++++++++++++r+++++++++++++++++++++++++++++++++++++++++++++++++++++++++++++++++++++++++++++++++++++++++++++++++++++++++++++++++++++++++++++++++++++++++++++++++++
++++++rrrrrrrrrrrrrrrrrrrrrrrrrrrrrrrrrrrrrrrrrrrrrrrrrrrrrrrrrrrrrrrrrrrrrrrrrrrrrrrrrrrrrrrrrrrrrrrrrrrrrrrrrrrrrrrrrrrrrrrrrrrrrrrrrrrrrrrrrrrrrrrrrrrrrrrrrrrrrrrrrrrrrrrrrrrrrrrrrrrrrrrrrrrrrrrrrrrrrrrrrrr++++++
++++++r++++++++++++++++++++++++++++++++r+++++++++O++++++^++^+++^+++++++++++++++++++++++++++3++++++++++++++++++++++++++++++++++++++++++++++++++++++++++++++++++++++++O+++++^++^++++O+++++++++++++++++++++++++++++r++++++
++++++r++++++++++++++++++++++++++++++++r+++++++++O+++++++^^+^++^+++++++++++4++++++++^^++++++++++++++3+++++++++++++++++++++++++++++++++++++++++++++++++++++++++++++++O++^+++++^++++O+++++++++++++++++++++++++++++r++++++
++++++r+++++++++++++++++++M++++++++++++r+++++rrrrrrrrrrrrrrrrrrrrrrrrrrrrrrrrrrrrrrrrrrrrrrrrrrrrrrrrrrrrrrrrrrrrrrr++++++++++++++++++++++++++++++1++++++1++++++++++O++^++++^+++++O+++++++++++++++++++++++++++++r++++++
++++++r+++++++++++++++++++++S++++++++++r+++++++++++++++++++++++++++++++++++++++++++++++++++++++++++O++++^++++++++++r++++++++++++++++++++++2+++++++++1+++1+++++++++++O++++^+++^+++O+++++++1+1++++++++++++++++++++r++++++
++++++r++++++++++++++++++++++++++++++++r+++++++++++++++++++++++++++++++++++++++++++++++++++++++++++O+++^+++++++++++r+++++rrrrrrrrrrrr+++++++++++++++++1++++++++++Tr++++++^++^++++O++++++++++++++++1+1+++++++++++r++++++
++++++r++++++++++++++++++++++++++++++++r++++++++111+++++++11++1++++++++1+++++1++++1++++++++1+++++++O++^+++^++++++++rOO+++r++++++++++++++++++++++++++++++++++++++++r++++++^+++^+++O++++++++++++++++++++++1+++++++r++++++
++++++r++++++++++++++++++++++++++++++++r+++++++++++++1+1+++++++1++++11+++1++++++++++111++++++++++++O++^++^+++++++++r^+++^r&+++++++++++++++++++++++++++++++++++++++r+++++++^+^+++++O+++++++++++++++++++++++++++++r++++++
++++++r++++++++++++++++++++++++++++++++r+++++++++++++++++++++++++++++++++++++++++++++++++++++++++++O++^+++^++++++++r^^^++rrrrrrrrrrrrrrrrrrrrrrrrrrrrrrrrrrrrrrrrrrrrrrrrrrrrrrrrrrrrrr+++++++++++++++++++rrrrrrr++++++
++++++r++++++++++++++++++++++++++++++++r+++++++++++++++++++++++++++++++++++++++++++++++++++++++++++O++^+++^++++++++r+++++r++++++++++r+++++++++++++++++++++++++++++++++++++++++++++++++++++++++++++++++++++++++++r++++++
++++++r++++++++++++++++++++++++++rrrrrrrrrrrrrrrrrrrrrrrrrrrrrrrrrrrrrrrrrrrrrrrrrrrrrrrrrrrrrrrrrrrrrrrrrrrrrrrrrrr^^^^^r++++++++++r+++++++++++++++++++++++++++++++++++++++++++++++R++3++++++++++++++++++++++++r++++++
++++++r+++++++++++++++++++++++++++++++++++++++++++++++++++3++++++++^+++^+++++++++++++++++++++++++++++++++++++++++++++++++r++++++++++r+++++++++++++++++++++++++++++++++++++++++++++R+++++++++++++++++++++++++++++r++++++
++++++r++++++++++++++++++++++++++++++++++++++++++++3+++++++++++++++^++^++++O+++^+++++++3++++++&++++++++++++++++++++++++++r+++++3++++r+++++++++++++++++++++++++++++++++++++++++++R+++++3+++++++++++++++++++++++++r++++++
++++++r++++++++++++++++++++++++++++++++++++++++++++++++3++++++++++++^+++^++++O+^+++++++++++++++++++++4+++++++++++++++++++r++++++++++r+++++++++++++++++++++++++++++++++++++++++R+++++3+++++++++++++++++++++++++++r++++++
++++++rrrrrrrrrrrrrrrrrrrrrrrrrrrrrrrrrrrrrrrrrrrrrrrrrrrrrrrrrrrrrrrrrrrrrrrrrrrrrrrrrrrrrrrrrrrrrrrrrrrrrrrrrrrrrrrrrrrr++++++++++rrrrrrrrrrrrrrrrrrrrrrrrrrrrrrrrrrrrrrrrrr++++++++++++++++++++++++++++++++++r++++++
++++++r++++++++++++++++++++++++++++^+++O+++^++++^++++++++++++++^++++^++++O+++^+++^++^+++++^+++++++++++++3+++++++3+++++++++++++++++++++++++^+O++^+++++3+++++++++^++++3+++++++++++++++++++++++++++++++++++++++++++r++++++
++++++r++MEEE+++++++++++++++++++++++^++O+++++^++^+++^+++++^^+++++^+++++++^++++^++^+^+^+++O^+++++4++++++++++++++++++++++++++++++++++++++++^+^++++^+O+++++++^++++3++++++++++++++++++++++++++++++++++++++++++++++++r++++++
++++++rrrrrrrrrrrrrrrrrrrrrrrrrrrrrrrrrrrrrrrrrrrrrrrrrrrrrrrrrrrrrrrrrrrrrrrrrrrrrrrrrrrrrrrrrrrrrrrrrrrrrrrrrrrrrrrrrrrrrrrrrrrrrrrrrrrrrrrrrrrrrrrrrrrrrrrrrrrrrrrrrrrrrrrrrrrrrrrrrrrrrrrrrrrrrrrrrrrrrrrrrrr++++++
++++++++++++++r++++++++++++++++++++++++++++++++++++++++++++++++++++r+++++++++++++++++++++++++++++++++++++++++++++++++++++++++++++++++++++++++++++++++++++++++++++++++++++++++++++++++++++++++++++++++++++++++++++++++++
+++++++++++++++++++++++++++++++++++++++++++++++++++++++++++++++++++r+++++++++++++++++++++++++++++++++++++++++++++++++++++++++++++++++++++++++++++++++++++++++++++++++++++++++++++++++++++++++++++++++++++++++++++++++++
++++++++++++++r++++++++++++++++++++++++++++++++++++++++++++++++++++r+++++++++++++++++++++++++++++++++++++++++++++++++++++++++++++++++++++++++++++++++++++++++++++++++++++++++++++++++++++++++++++++++++++++++++++++++++
+T++++++r+++T+++++++++++++++++++++++++++++++T++++++++++++++++++++++r+++++++++++++++++++++++++++++++++++++++++++++++++++++++++++++++++++++++++++++++++++++++++++++++++++++++++++++++++++++++++++++++++++++++++++++++++++

