+++++++++++++++++++++++++++++++++++++++++++++++++++++++++++++++++++++++++++++++++++++++++++
+++++++++++++++++++++++++++++++++++++++++++++++++++++++++++++++++++++++++++++++++++++++++++
+++++++++++++++++++++++++++++++++++++++++++++++++++++++++++++++++++++++++++++++++++++++++++
+++++++++++++++++++++++++T+++++++++++++++++++++++++++++++++++++++++++++++++++++++++++++++++
+++++++++++++++++++++++++++++++++++++++++++++++++++++++++++++++++++++++++++++++++++++++++++
+++++++++rrrrrrrrrrrrrrrrrrrrrrrrrrrrrrrrrrrrrrrrrrrrrrrrrrrrrrrrrr++++++++++++++++++++++++
+++++++++r++++++++++++++++++++++++++++++++++3++++++++++++++++++++++r+++++++++++++++++++++++
+++++++++r++++++++++++++++++++++++++++++++++++++&+++++++++++++++++++r++++++++++++++++++++++
+++++++++r++++M+S+++++++++++++1++1++1++++++++++++++++++++++++++++++++r+++++++++++++++++++++
+++++++++r++++++++++++++++++++++++++++++3++++++++++++++++2++++++++++++r++++++++++++++++++++
+++++++++r+++++++++++++++++++++++++++++++++++++++++++++++++++++++++++++r+++++++++++++++++++
+++++++++rrrrrrrrrrrrrrrrrrrrrrrrrrrrrrrrrrrrrrrrrrr++++++++++++++++++++r++++++++++++++++++
+++++++++r++++++++++++++++++++r++++++++++++++++++++3+++++++++++++++++++++r+++++++++++++++++
+++++++++r++++++++++++++++++++r+++++++++++++++&+++++++++++++++++++++++++++r++++++++++++++++
+++++++++r++++++++++++++++++++r++++++++++++++++++&+++++++++++++++++++++++++r+++++++++++++++
+++++++++r++++++++++++++++++++rrrrrrrrrrrrrrrrrrrrrr++++++++++++++++++++++++r++++++++++++++
+++++++++r++++++++++2++++++++++++++++++++++++++++++++++++++++++++++++++++++r+++++++++++++++
+++++++++r++++++++++++++++++++++++++++++++++++++++++++++++++++++++++++++++r++++++++++++++++
+++++++++r++++++++++++++++++1++++++++++++1++++++++++1+1++1+++++++++++++++r+++++++++++++++++
+++++++++r++++++++++++++++++++++++++++++++++++++++++++++++++++++++++++++r++++++++++++++++++
+++++++++r+++++++++++++++++++++1++++++++++++1++++++++++++++++++++++++++r+++++++++++++++++++
+++++++++r+++++++++++++++++++++++++++++1+++++++++1++++++++++++++++++++r++++++++++++++++++++
+++++++++r+++++++++++++++++++++++++++++++++++++++++++++++++++++++++++r+++++++++++++++++++++
+++++++++r+++++++++4++++++++++++++++++++++++++++++++++++++++++++++++r++++++++++++++++++++++
+++++++++rrrrrrrrrrrrrrrOOOOOOrrrrrrrrrrrrrrrrrrrrrrrrrrrrrrrrrrrrrr+++++++++++++++++++++++
+++++++++r+++++++++++++r++++++r++++++++++++++++++++++++++++++++++++++++++++++++++++++++++++
+++++++++r++++++++OOOOOr^^^^^+r++++++++++++++++++++++++++++++++++++++++++++++++++++++++++++
+++++++++r+++++rIIIIIIIr^^^+++r++++++++++++++++++++++++++++++++++++++++++++++++++++++++++++
+++++++++r^^^^^rIIIIIIIr++++++r++++++++++++++++++++++++++++++++++++++++++++++++++++++++++++
+++++++++r+++++r+IIIII+r+^^^^+r++++++++++++++++++++++++++++++++++++++++++++++++++++++++++++
+++++++++r+^+^+r+++II++r++++++r++++++++++++++++++++++++++++++++++++++++++++++++++++++++++++
+++++++++r++^++r++++++++++OO++r++++++++++++++++++++++++++++++++++++++++++++++++++++++++++++
+++++++++r+++++r++++++++++++++r++++++++++++++++++++++++++++++++++++++++++++++++++++++++++++
+++++++++r+OOO+rrrrrrrrrrrrrrrr++++++++++++++++++++++++++++++++++++++++++++++++++++++++++++
+++++++++r+++++++++++IIIIIIIIIr++++++++++++++++++++++++++++++++++++++++++++++++++++++++++++
+++++++++r+++++++++++IIIIIIIIIr++++++++++++++++++++++++++++++++++++++++++++++++++++++++++++
+++++++++r+++++++++++++IIIIIIIr++++++++++++++++++++++++++++++++++++++++++++++++++++++++++++
+++++++++rrrrrrrrrrrrrrr^^^^^^r++++++++++++++++++++++++++++++++++++++++++++++++++++++++++++
+++++++++r++++++r++++++r++++++r++++++++++++++++++++++++++++++++++++++++++++++++++++++++++++
+++++++++r++++++r++++++r+++^^^r++++++++++++++++++++++++++++++++++++++++++++++++++++++++++++
+++++++++r++++++r++++++r^^^+++r++++++++++++++++++++++++++++++++++++++++++++++++++++++++++++
+++++++++r+4+++++++11++r++^^^+r++++++++++++++++++++++++++++++++++++++++++++++++++++++++++++
+++++++++r+++++++++++++r++++++r++++++++++++++++++++++++++++++++++++++++++++++++++++++++++++
+++++++++r^^^^^^r+++++++++++++r++++++++++++++++++++++++++++++++++++++++++++++++++++++++++++
+++++++++r++++++r+++++++++++++r++++++++++++++++++++++++++++++++++++++++++++++++++++++++++++
+++++++++r++++++rrrrrrrrrrrrrrr++++++++++++++++++++++++++++++++++++++++++++++++++++++++++++
+++++++++r++++++++++++++++EEE+r++++++++++++++++++++++++++++++++++++++++++++++++++++++++++++
+++++++++r++++++++++++++EEEEM+r++++++++++++++++++++++++++++++++++++++++++++++++++++++++++++
+++++++++rrrrrrrrrrrrrrrrrrrrrr++++++++++++++++++++++++++++++++++++++++++++++++++++++++++++
+++++++++++++++++++++++++++++++++++++++++++++++++++++++++++++++++++++++++++++++++++++++++++
+++++++++++++++++++++++++++++++++++++++++++++++++++++++++++++++++++++++++++++++++++++++++++
+++++++++++++++++++++++++++++++++++++++++++++++++++++++++++++++++++++++++++++++++++++++++++
+++++++++++++++++++++++++T+++++++++++++++++++++++++++++++++++++++++++++++++++++++++++++++++
+++++++++++++++++++++++++++++++++++++++++++++++++++++++++++++++++++++++++++++++++++++++++++

